Traditional	Simplified	Pinyin
一	一	yī
在	在	zài
有	有	yǒu
個	个	gè
我	我	wǒ
不	不	bù
這	这	zhè
他	他	tā
也	也	yě
就	就	jiù
人	人	rén
都	都	dōu
說	说	shuō
而	而	ér
們	们	men
你	你	nǐ
了	了	le
要	要	yào
會	会	huì
對	对	duì
及	及	jí
和	和	hé
與	与	yǔ
以	以	yǐ
很	很	hěn
種	种	zhǒng
的	的	de
大	大	dà
能	能	néng
著	着	zhe
她	她	tā
那	那	nà
上	上	shàng
但	但	dàn
年	年	nián
還	还	hái
可以	可以	kěyǐ
最	最	zuì
自己	自己	zìjǐ
為	为	wéi
來	来	lái
所	所	suǒ
他們	他们	tāmen
兩	两	liǎng
各	各	gè
可	可	kě
為	为	wéi
或	或	huò
好	好	hǎo
等	等	děng
又	又	yòu
將	将	jiāng
因為	因为	yīnwèi
於	于	yú
由	由	yóu
從	从	cóng
更	更	gèng
被	被	bèi
才	才	cái
已	已	yǐ
者	者	zhě
每	每	měi
次	次	cì
把	把	bǎ
三	三	sān
什麼	什么	shénme
問題	问题	wèntí
其	其	qí
讓	让	ràng
此	此	cǐ
做	做	zuò
再	再	zài
所以	所以	suǒyǐ
只	只	zhǐ
則	则	zé
台灣	台湾	Táiwān
卻	却	què
並	并	bìng
位	位	wèi
想	想	xiǎng
去	去	qù
呢	呢	ne
學生	学生	xuéshēng
表示	表示	biǎoshì
到	到	dào
公司	公司	gōngsī
將	将	jiāng
如果	如果	rúguǒ
社會	社会	shèhuì
看	看	kàn
小	小	xiǎo
天	天	tiān
因此	因此	yīncǐ
新	新	xīn
但是	但是	dànshì
它	它	tā
中	中	zhōng
使	使	shǐ
工作	工作	gōngzuò
全	全	quán
覺得	觉得	juéde
使用	使用	shǐyòng
這些	这些	zhèxiē
裡	里	lǐ
並	并	bìng
由於	由于	yóuyú
時候	时候	shíhòu
知道	知道	zhīdào
這樣	这样	zhèyàng
一	一	yī
認為	认为	rènwéi
時間	时间	shíjiān
事	事	shì
過	过	guò
向	向	xiàng
可能	可能	kěnéng
中國	中国	Zhōngguó
美國	美国	Měiguó
到	到	dào
和	和	hé
幾	几	jǐ
系統	系统	xìtǒng
政府	政府	zhèngfǔ
大家	大家	dàjiā
國家	国家	guójiā
許多	许多	xǔduō
生活	生活	shēnghuó
跟	跟	gēn
已經	已经	yǐjīng
大學	大学	dàxué
研究	研究	yánjiù
因	因	yīn
本	本	běn
二	二	èr
活動	活动	huódòng
該	该	gāi
世界	世界	shìjiè
應	应	yīng
四	四	sì
希望	希望	xīwàng
方式	方式	fāngshì
內	内	nèi
項	项	xiàng
啊	啊	ā
下	下	xià
環境	环境	huánjìng
一些	一些	yīxiē
必須	必须	bìxū
文化	文化	wénhuà
高	高	gāo
孩子	孩子	háizi
沒有	没有	méiyǒu
不能	不能	bùnéng
如	如	rú
開始	开始	kāishǐ
元	元	yuán
不同	不同	bùtóng
仍	仍	réng
網路	网路	wǎnglù
日本	日本	rìběn
用	用	yòng
中心	中心	zhōngxīn
來	来	lái
對	对	duì
雖然	虽然	suīrán
重要	重要	zhòngyào
地方	地方	dìfāng
進行	进行	jìnxíng
關係	关系	guānxì
市場	市场	shìchǎng
太	太	tài
老師	老师	lǎoshī
提供	提供	tígōng
學校	学校	xuéxiào
應該	应该	yīnggāi
指出	指出	zhǐchū
經濟	经济	jīngjì
其他	其他	qítā
家	家	jiā
發展	发展	fāzhǎn
教育	教育	jiàoyū
成為	成为	chéngwéi
多	多	duō
非常	非常	fēicháng
便	便	biàn
方面	方面	fāngmiàn
很多	很多	hěnduō
吃	吃	chī
然後	然后	ránhòu
未	未	wèi
發現	发现	fāxiàn
電腦	电脑	diànnǎo
一樣	一样	yīyàng
而且	而且	érqiě
心	心	xīn
不過	不过	búguò
無法	无法	wúfǎ
企業	企业	qǐyè
正	正	zhèng
服務	服务	fúwù
較	较	jiào
不會	不会	búhuì
臺灣	台湾	táiwān
曾	曾	céng
嗎	吗	mā
空間	空间	kōngjiān
看到	看到	kàndào
五	五	wǔ
如何	如何	rúhé
國內	国内	guónèi
們	们	men
無	无	wú
對於	对于	duìyú
以及	以及	yǐjí
之後	之后	zhīhòu
可是	可是	kěshì
當	当	dāng
人員	人员	rényuán
比	比	bǐ
先	先	xiān
產品	产品	chǎnpǐn
資訊	资讯	zīxùn
資料	资料	zīliào
比較	比较	bǐjiào
先生	先生	xiānshēng
地	地	dì
除了	除了	chúle
大陸	大陆	dàlù
需要	需要	xūyào
像	像	xiàng
在	在	zài
給	给	gěi
歲	岁	suì
請	请	qǐng
月	月	yuè
些	些	xiē
名	名	míng
另	另	lìng
若	若	ruò
亦	亦	yì
地區	地区	dìqū
技術	技术	jìshù
至	至	zhì
特別	特别	tèbié
其實	其实	qíshí
國際	国际	guójì
不要	不要	búyào
發生	发生	fāshēng
參加	参加	cānjiā
一定	一定	yīdìng
其中	其中	qízhōng
問	问	wèn
台北	台北	táiběi
包括	包括	bāokuò
講	讲	jiǎng
造成	造成	zàochéng
看	看	kàn
像	像	xiàng
常	常	cháng
即	即	jí
喜歡	喜欢	xǐhuān
去	去	qù
沒	没	méi
出現	出现	chūxiàn
政治	政治	zhèngzhì
話	话	huà
走	走	zǒu
單位	单位	dānwèi
一直	一直	yīzhí
吧	吧	ba
是否	是否	shìfǒu
當然	当然	dāngrán
整	整	zhěng
處理	处理	chǔlǐ
歷史	历史	lìshǐ
了解	了解	liǎojiě
那	那	nà
怎麼	怎么	zěnme
機會	机会	jīhuì
家	家	jiā
聽	听	tīng
所有	所有	suǒyǒu
只要	只要	zhǐyào
朋友	朋友	péngyou
令	令	lìng
甚至	甚至	shènzhì
用	用	yòng
真	真	zhēn
六	六	liù
呀	呀	ya
情況	情况	qíngkuàng
還是	还是	háishì
錢	钱	qián
方法	方法	fāngfǎ
點	点	diǎn
任何	任何	rènhé
經驗	经验	jīngyàn
藝術	艺术	yìshù
你們	你们	nǐmen
十	十	shí
主要	主要	zhǔyào
媽媽	妈妈	māmā
增加	增加	zēngjiā
提出	提出	tíchū
為什麼	为什么	wèishéme
以	以	yǐ
您	您	nín
計畫	计画	jìhuà
作	作	zuò
利用	利用	lìyòng
東西	东西	dōngxī
在	在	zài
條	条	tiáo
設計	设计	shèjì
找	找	zhǎo
之間	之间	zhījiān
成長	成长	chéngzhǎng
能夠	能够	nénggòu
決定	决定	juédìng
學習	学习	xuéxí
誰	谁	shéi
見	见	jiàn
半	半	bàn
時代	时代	shídài
完成	完成	wánchéng
帶	带	dài
相當	相当	xiāngdāng
同學	同学	tóngxué
件	件	jiàn
能力	能力	nénglì
別人	别人	biérén
生命	生命	shēngmìng
下	下	xià
來	来	lái
場	场	cháng
會議	会议	huìyì
容易	容易	róngyì
開發	开发	kāifā
民眾	民众	mínzhòng
事情	事情	shìqíng
書	书	shū
事實	事实	shìshí
有關	有关	yǒuguān
自	自	zì
組織	组织	zǔzhī
言	言	yán
多	多	duō
愛	爱	ài
建立	建立	jiànlì
相關	相关	xiāngguān
均	均	jūn
產生	产生	chǎnshēng
多	多	duō
業者	业者	yèzhě
解決	解决	jiějué
完全	完全	wánquán
的話	的话	dehuà
接受	接受	jiēshòu
知	知	zhī
約	约	yuē
一般	一般	yībān
推動	推动	tuīdòng
過程	过程	guòchéng
管理	管理	guǎnlǐ
功能	功能	gōngnéng
手	手	shǒu
打	打	dǎ
水	水	shuǐ
要求	要求	yāoqiú
小朋友	小朋友	xiǎopéngyǒu
教授	教授	jiàoshòu
難	难	nán
我國	我国	wǒguó
告訴	告诉	gàosù
內容	内容	nèiróng
結果	结果	jiéguǒ
調查	调查	diàochá
家庭	家庭	jiātíng
成立	成立	chénglì
選擇	选择	xuǎnzé
經營	经营	jīngyíng
然而	然而	ránér
父母	父母	fùmǔ
寫	写	xiě
人類	人类	rénlèi
至於	至于	zhìyū
買	买	mǎi
尤其	尤其	yóuqí
配合	配合	pèihé
進入	进入	jìnrù
例如	例如	lìrú
得	得	děi
討論	讨论	tǎolùn
依	依	yī
作品	作品	zuòpǐn
情形	情形	qíngxíng
資源	资源	zīyuán
原因	原因	yuányīn
啦	啦	lā
妳	妳	nǐ
運動	运动	yùndòng
觀念	观念	guānniàn
給	给	gěi
軟體	软体	ruǎntǐ
品質	品质	pǐnzhí
經過	经过	jīngguò
如此	如此	rúcǐ
嗯	嗯	ēn
精神	精神	jīngshén
影響	影响	yǐngxiǎng
之	之	zhī
過	过	guò
好像	好像	hǎoxiàng
成	成	chéng
參與	参与	cānyū
以後	以后	yǐhòu
於是	于是	yūshì
部分	部分	bùfèn
另外	另外	lìngwài
公園	公园	gōngyuán
透過	透过	tòuguò
訓練	训练	xùnliàn
努力	努力	nǔlì
研究	研究	yánjiù
具有	具有	jùyǒu
共同	共同	gòngtóng
所謂	所谓	suǒwèi
下	下	xià
行為	行为	xíngwéi
合作	合作	hézuò
經	经	jīng
合作	合作	hézuò
目標	目标	mùbiāo
起來	起来	qǐlái
考慮	考虑	kǎolù
長	长	cháng
意見	意见	yìjiàn
辦法	办法	bànfǎ
音樂	音乐	yīnyuè
連	连	lián
受	受	shòu
廠商	厂商	chǎngshāng
隻	只	zhī
受到	受到	shòudào
一切	一切	yīqiè
或是	或是	huòshì
中央	中央	zhōngyāng
某	某	mǒu
女性	女性	nǔxìng
教學	教学	jiāoxué
極	极	jí
獲得	获得	huòdé
真的	真的	zhēnde
路	路	lù
來	来	lái
快	快	kuài
國小	国小	guóxiǎo
部份	部份	bùfèn
工程	工程	gōngchéng
女人	女人	nǔrén
舉行	举行	jǔxíng
句	句	jù
只是	只是	zhǐshì
段	段	duàn
根據	根据	gēnjù
現象	现象	xiànxiàng
人民	人民	rénmín
土地	土地	tǔdì
面對	面对	miànduì
注意	注意	zhùyì
這裡	这里	zhèlǐ
新聞	新闻	xīnwén
繼續	继续	jìxù
相信	相信	xiāngxìn
政策	政策	zhèngcè
變成	变成	biànchéng
計劃	计划	jìhuà
強調	强调	qiángdiào
學	学	xué
人士	人士	rénshì
前	前	qián
前	前	qián
存在	存在	cúnzài
制度	制度	zhìdù
意義	意义	yìyì
代表	代表	dàibiǎo
課程	课程	kèchéng
該	该	gāi
沒	没	méi
至	至	zhì
需求	需求	xūqiú
人生	人生	rénshēng
那些	那些	nǎxiē
成功	成功	chénggōng
爸爸	爸爸	bàbà
產業	产业	chǎnyè
負責	负责	fùzé
民間	民间	mínjiān
雖	虽	suī
影響	影响	yǐngxiǎng
直接	直接	zhíjiē
幾乎	几乎	jīhū
分	分	fèn
實際	实际	shíjì
團體	团体	tuántǐ
價值	价值	jiàzhí
使得	使得	shǐdé
類	类	lèi
形成	形成	xíngchéng
科技	科技	kējì
這麼	这么	zhème
當	当	dāng
七	七	qī
不但	不但	búdàn
往	往	wǎng
本身	本身	běnshēn
標準	标准	biāozhǔn
似乎	似乎	sìhū
應用	应用	yìngyòng
或者	或者	huòzhě
動物	动物	dòngwù
電話	电话	diànhuà
態度	态度	tàidù
建設	建设	jiànshè
事業	事业	shìyè
老	老	lǎo
那麼	那么	nàmo
常常	常常	chángcháng
字	字	zì
坐	坐	zuò
舉辦	举办	jǔbàn
自我	自我	zìwǒ
有的	有的	yǒude
具	具	jù
目的	目的	mùdì
塊	块	kuài
條件	条件	tiáojiàn
即使	即使	jíshǐ
好	好	hǎo
十分	十分	shífēn
多少	多少	duōshǎo
放	放	fàng
又	又	yòu
電影	电影	diànyǐng
科學	科学	kēxué
執行	执行	zhíxíng
邊	边	biān
委員會	委员会	wěiyuánhuì
溝通	沟通	gōutōng
開	开	kāi
一起	一起	yīqǐ
張	张	zhāng
針對	针对	zhēnduì
員工	员工	yuángōng
引起	引起	yǐnqǐ
自然	自然	zìrán
那麼	那么	nàmo
安全	安全	ānquán
總統	总统	zǒngtǒng
此外	此外	cǐwài
擁有	拥有	yǒngyǒu
並且	并且	bìngqiě
事件	事件	shìjiàn
設計	设计	shèjì
研究所	研究所	yánjiùsuǒ
語言	语言	yǔyán
嚴重	严重	yánzhòng
故事	故事	gùshì
學術	学术	xuéshù
片	片	piàn
設備	设备	shèbèi
之外	之外	zhīwài
車	车	chē
基本	基本	jīběn
實在	实在	shízài
久	久	jiǔ
套	套	tào
達到	达到	dádào
改善	改善	gǎishàn
死	死	sǐ
結構	结构	jiégòu
住	住	zhù
皆	皆	jiē
改變	改变	gǎibiàn
拿	拿	ná
小組	小组	xiǎozǔ
支持	支持	zhīchí
座	座	zuò
醫院	医院	yīyuàn
既	既	jì
僅	仅	jǐn
值得	值得	zhíde
學者	学者	xuézhě
八	八	bā
交通	交通	jiāotōng
階段	阶段	jiēduàn
就是	就是	jiùshì
申請	申请	shēnqǐng
主管	主管	zhǔguǎn
申請	申请	shēnqǐng
同	同	tóng
感覺	感觉	gǎnjué
電視	电视	diànshì
母親	母亲	mǔqīn
嘛	嘛	má
香港	香港	xiānggǎng
記者	记者	jìzhě
壓力	压力	yālì
快樂	快乐	kuàilè
喝	喝	hē
敢	敢	gǎn
院	院	yuàn
也許	也许	yěxǔ
人們	人们	rénmen
談	谈	tán
生產	生产	shēngchǎn
怕	怕	pà
就	就	jiù
身體	身体	shēntǐ
規定	规定	guīdìng
程度	程度	chéngdù
積極	积极	jījí
知識	知识	zhīshì
作為	作为	zuòwéi
機構	机构	jīgòu
而是	而是	érshì
鼓勵	鼓励	gǔlì
角色	角色	jiǎosè
狀況	状况	zhuàngkuàng
專家	专家	zhuānjiā
據	据	jù
清楚	清楚	qīngchǔ
不僅	不仅	bùjǐn
比賽	比赛	bǐsài
玩	玩	wán
效果	效果	xiàoguǒ
越	越	yuè
保護	保护	bǎohù
共	共	gòng
開放	开放	kāifàng
附近	附近	fùjìn
上	上	shàng
父親	父亲	fùqīn
專業	专业	zhuānyè
經費	经费	jīngfèi
曾經	曾经	céngjīng
工作	工作	gōngzuò
願意	愿意	yuànyì
分別	分别	fēnbié
重視	重视	zhòngshì
不少	不少	bùshǎo
歡迎	欢迎	huānyíng
小孩	小孩	xiǎohái
小時	小时	xiǎoshí
中國人	中国人	zhōngguórén
顯示	显示	xiǎnshì
中共	中共	zhōnggòng
出	出	chū
男人	男人	nánrén
避免	避免	bìmiǎn
屬於	属于	shǔyū
實施	实施	shíshī
聲音	声音	shēngyīn
主義	主义	zhǔyì
行動	行动	xíngdòng
不可	不可	bùkě
只有	只有	zhǐyǒu
校園	校园	xiàoyuán
興趣	兴趣	xìngqù
山	山	shān
表現	表现	biǎoxiàn
得	得	dé
回來	回来	huílái
主任	主任	zhǔrèn
裡面	里面	lǐmiàn
經常	经常	jīngcháng
不再	不再	búzài
電子	电子	diànzǐ
受	受	shòu
思想	思想	sīxiǎng
頭	头	tóu
終於	终于	zhōngyū
謝謝	谢谢	xièxiè
協助	协助	xiézhù
除	除	chú
當地	当地	dāngdì
正式	正式	zhèngshì
真正	真正	zhēnzhèng
低	低	dī
性	性	xìng
份	份	fèn
因素	因素	yīnsù
推出	推出	tuīchū
上	上	shàng
價格	价格	jiàgé
去	去	qù
認識	认识	rènshì
方向	方向	fāngxiàng
責任	责任	zérèn
說明	说明	shuōmíng
工業	工业	gōngyè
大量	大量	dàliàng
做	做	zuò
逐漸	逐渐	zhújiàn
心理	心理	xīnlǐ
一點	一点	yīdiǎn
供	供	gōng
須	须	xū
簡單	简单	jiǎndān
運用	运用	yùnyòng
觀察	观察	guānchá
往往	往往	wǎngwǎng
規劃	规划	guīhuà
減少	减少	jiǎnshǎo
重新	重新	chóngxīn
業務	业务	yèwù
報導	报导	bàodǎo
仍然	仍然	réngrán
感到	感到	gǎndào
開放	开放	kāifàng
領域	领域	lǐngyū
有效	有效	yǒuxiào
女	女	nǔ
要	要	yào
從事	从事	cóngshì
發揮	发挥	fāhuī
人才	人才	réncái
反而	反而	fǎnér
行政	行政	xíngzhèng
銀行	银行	yínháng
公共	公共	gōnggòng
媒體	媒体	méitǐ
提高	提高	tígāo
代	代	dài
自然	自然	zìrán
社區	社区	shèqū
力量	力量	lìliàng
啊	啊	ā
教育部	教育部	jiàoyūbù
愈	愈	yū
超過	超过	chāoguò
維持	维持	wéichí
家長	家长	jiāzhǎng
結合	结合	jiéhé
校長	校长	xiàozhǎng
通常	通常	tōngcháng
缺乏	缺乏	quēfá
委員	委员	wěiyuán
特色	特色	tèsè
結果	结果	jiéguǒ
有時	有时	yǒushí
教師	教师	jiàoshī
之前	之前	zhīqián
遠	远	yuǎn
控制	控制	kòngzhì
本	本	běn
否則	否则	fǒuzé
法	法	fǎ
少	少	shǎo
原則	原则	yuánzé
要	要	yào
臉	脸	liǎn
通過	通过	tōngguò
建議	建议	jiànyì
工具	工具	gōngjù
作業	作业	zuòyè
達	达	dá
節目	节目	jiémù
智慧	智慧	zhìhuì
來自	来自	láizì
而	而	ér
變化	变化	biànhuà
同樣	同样	tóngyàng
形式	形式	xíngshì
站	站	zhàn
以為	以为	yǐwéi
健康	健康	jiànkāng
擔任	担任	dānrèn
人口	人口	rénkǒu
規劃	规划	guīhuà
剛	刚	gāng
特殊	特殊	tèshū
原來	原来	yuánlái
道	道	dào
分	分	fēn
傳統	传统	chuántǒng
總是	总是	zǒngshì
前往	前往	qiánwǎng
投資	投资	tóuzī
加強	加强	jiāqiáng
不斷	不断	búduàn
對象	对象	duìxiàng
追求	追求	zhuīqiú
加上	加上	jiāshàng
比	比	bǐ
思考	思考	sīkǎo
製作	制作	zhìzuò
台北市	台北市	táiběishì
取得	取得	qǔdé
出來	出来	chūlái
加入	加入	jiārù
台	台	tái
安排	安排	ānpái
兒童	儿童	értóng
國中	国中	guózhōng
範圍	范围	fànwéi
老人	老人	lǎorén
雙方	双方	shuāngfāng
牠	牠	tā
北京	北京	běijīng
年輕	年轻	niánqīng
結束	结束	jiéshù
教	教	jiāo
程式	程式	chéngshì
婦女	妇女	fùnǔ
找到	找到	zhǎodào
彼此	彼此	bǐcǐ
全球	全球	quánqiú
成本	成本	chéngběn
回到	回到	huídào
部	部	bù
而已	而已	éryǐ
之下	之下	zhīxià
等	等	děng
變	变	biàn
期間	期间	qíjiān
非	非	fēi
小姐	小姐	xiǎojiě
整體	整体	zhěngtǐ
採用	采用	cǎiyòng
根本	根本	gēnběn
叫	叫	jiào
歐洲	欧洲	ōuzhōu
正在	正在	zhèngzài
加以	加以	jiāyǐ
充滿	充满	chōngmǎn
系列	系列	xìliè
隨著	随着	suízhe
早	早	zǎo
等等	等等	děngděng
頗	颇	pǒ
不足	不足	bùzú
總	总	zǒng
分析	分析	fēnxī
深	深	shēn
報告	报告	bàogào
不錯	不错	búcuò
在於	在于	zàiyū
旁	旁	páng
笑	笑	xiào
故	故	gù
消費者	消费者	xiāofèizhě
意識	意识	yìshì
公尺	公尺	gōngchǐ
民族	民族	mínzú
為主	为主	wéizhǔ
大眾	大众	dàzhòng
到底	到底	dàodǐ
願	愿	yuàn
度	度	dù
大概	大概	dàgài
對方	对方	duìfāng
官員	官员	guānyuán
發表	发表	fābiǎo
進一步	进一步	jìnyībù
自由	自由	zìyóu
正確	正确	zhèngquè
豐富	丰富	fēngfù
國民黨	国民党	guómíndǎng
戰爭	战争	zhànzhēng
怎麼樣	怎么样	zěnmeyàng
只好	只好	zhǐhǎo
明顯	明显	míngxiǎn
改革	改革	gǎigé
表達	表达	biǎodá
肯定	肯定	kěndìng
強	强	qiáng
高興	高兴	gāoxìng
哪	哪	nǎ
樹	树	shù
適合	适合	shìhé
茶	茶	chá
別	别	bié
國外	国外	guówài
關心	关心	guānxīn
蘇聯	苏联	sūlián
成績	成绩	chéngjī
人物	人物	rénwù
聽到	听到	tīngdào
創造	创造	chuàngzào
不必	不必	búbì
不論	不论	búlùn
尚	尚	shàng
居民	居民	jūmín
不管	不管	bùguǎn
美麗	美丽	měilì
伊拉克	伊拉克	yīlākè
帶來	带来	dàilái
有	有	yǒu
般	般	bān
永遠	永远	yǒngyuǎn
感情	感情	gǎnqíng
兒子	儿子	érzi
這樣子	这样子	zhèyàngzi
起	起	qǐ
全部	全部	quánbù
回家	回家	huíjiā
獨立	独立	dúlì
英國	英国	yīngguó
投資	投资	tóuzī
理論	理论	lǐlùn
面臨	面临	miànlín
選手	选手	xuǎnshǒu
分鐘	分钟	fēnzhōng
內部	内部	nèibù
西方	西方	xīfāng
人家	人家	rénjiā
準備	准备	zhǔnbèi
眼睛	眼睛	yǎnjīng
如	如	rú
眼	眼	yǎn
離開	离开	líkāi
競爭	竞争	jìngzhēng
專利	专利	zhuānlì
成果	成果	chéngguǒ
活	活	huó
心情	心情	xīnqíng
介紹	介绍	jièshào
現場	现场	xiànchǎng
突然	突然	túrán
客戶	客户	kèhù
間	间	jiān
印象	印象	yìnxiàng
花	花	huā
海	海	hǎi
真正	真正	zhēnzhèng
保持	保持	bǎochí
時期	时期	shíqí
層	层	céng
保持	保持	bǎochí
方便	方便	fāngbiàn
幫助	帮助	bāngzhù
基礎	基础	jīchǔ
個人	个人	gèrén
新竹	新竹	xīnzhú
李	李	lǐ
生	生	shēng
圖書館	图书馆	túshūguǎn
她們	她们	tāmen
美元	美元	měiyuán
讀	读	dú
以來	以来	yǐlái
或許	或许	huòxǔ
課	课	kè
病人	病人	bìngrén
實驗	实验	shíyàn
有時候	有时候	yǒushíhòu
辦理	办理	bànlǐ
部門	部门	bùmén
類似	类似	lèisì
廣告	广告	guǎnggào
送	送	sòng
夠	够	gòu
新加坡	新加坡	xīnjiāpō
擔心	担心	dānxīn
商業	商业	shāngyè
掌握	掌握	zhǎngwò
兩岸	两岸	liǎngàn
門	门	mén
方案	方案	fāngàn
至少	至少	zhìshǎo
看法	看法	kànfǎ
原本	原本	yuánběn
措施	措施	cuòshī
表現	表现	biǎoxiàn
社團	社团	shètuán
九	九	jiǔ
展開	展开	zhǎnkāi
如	如	rú
博士	博士	bóshì
道路	道路	dàolù
竟	竟	jìng
項目	项目	xiàngmù
需	需	xū
學院	学院	xuéyuàn
代表	代表	dàibiǎo
同意	同意	tóngyì
原住民	原住民	yuánzhùmín
策略	策略	cèluè
白	白	bái
平均	平均	píngjūn
所	所	suǒ
靠	靠	kào
互相	互相	hùxiāng
地位	地位	dìwèi
體育	体育	tǐyù
樣	样	yàng
亞洲	亚洲	yǎzhōu
採取	采取	cǎiqǔ
日	日	rì
畢業	毕业	bìyè
相同	相同	xiāngtóng
欣賞	欣赏	xīnshǎng
法律	法律	fǎlù
詞	词	cí
大型	大型	dàxíng
中華	中华	zhōnghuá
台大	台大	táidà
意思	意思	yìsī
在一起	在一起	zàiyīqǐ
係	系	xì
持續	持续	chíxù
群	群	qún
慢慢	慢慢	mànmàn
高雄	高雄	gāoxióng
製造	制造	zhìzào
醫療	医疗	yīliáo
邀請	邀请	yāoqǐng
滿足	满足	mǎnzú
速度	速度	sùdù
重點	重点	zhòngdiǎn
保存	保存	bǎocún
評估	评估	pínggū
限制	限制	xiànzhì
符合	符合	fúhé
利益	利益	lìyì
組成	组成	zǔchéng
檢查	检查	jiǎnchá
看見	看见	kànjiàn
瞭解	瞭解	liǎojiě
立刻	立刻	lìkè
女兒	女儿	nǔér
數	数	shù
上課	上课	shàngkè
整合	整合	zhěnghé
更多	更多	gèngduō
唯一	唯一	wéiyī
人數	人数	rénshù
的確	的确	díquè
主題	主题	zhǔtí
用戶	用户	yònghù
快速	快速	kuàisù
設施	设施	shèshī
文學	文学	wénxué
步	步	bù
那裡	那里	nàlǐ
到	到	dào
美	美	měi
需要	需要	xūyào
失去	失去	shīqù
做為	做为	zuòwéi
複雜	复杂	fùzá
屆	届	jiè
作用	作用	zuòyòng
調整	调整	tiáozhěng
佔	佔	zhàn
要求	要求	yāoqiú
高中	高中	gāozhōng
動作	动作	dòngzuò
模式	模式	móshì
多	多	duó
吸引	吸引	xīyǐn
記得	记得	jìde
賣	卖	mài
例	例	lì
推廣	推广	tuīguǎng
本來	本来	běnlái
具體	具体	jùtǐ
太太	太太	tàitài
之中	之中	zhīzhōng
宗教	宗教	zōngjiào
舊	旧	jiù
反應	反应	fǎnyìng
觀眾	观众	guānzhòng
立場	立场	lìchǎng
旅遊	旅遊	lǔyóu
因而	因而	yīnér
理念	理念	lǐniàn
它們	它们	tāmen
上面	上面	shàngmiàn
回	回	huí
支	支	zhī
少年	少年	shàonián
輔導	辅导	fǔdǎo
爭取	争取	zhēngqǔ
輔導	辅导	fǔdǎo
想到	想到	xiǎngdào
可能	可能	kěnéng
尊重	尊重	zūnzhòng
替	替	tì
地點	地点	dìdiǎn
何	何	hé
黨	党	dǎng
進步	进步	jìnbù
欲	欲	yū
危機	危机	wéijī
正常	正常	zhèngcháng
角度	角度	jiǎodù
尚未	尚未	shàngwèi
院長	院长	yuànzhǎng
習慣	习惯	xíguàn
期	期	qí
環保	环保	huánbǎo
交流	交流	jiāoliú
困難	困难	kùnnán
需	需	xū
完整	完整	wánzhěng
費用	费用	fèiyòng
完整	完整	wánzhěng
上述	上述	shàngshù
呈現	呈现	chéngxiàn
照顧	照顾	zhàogù
達成	达成	dáchéng
批	批	pī
培養	培养	péiyǎng
垃圾	垃圾	lèsè
圖	图	tú
擴大	扩大	kuòdà
篇	篇	piān
比例	比例	bǐlì
風格	风格	fēnggé
難以	难以	nányǐ
機關	机关	jīguān
情緒	情绪	qíngxù
勞工	劳工	láogōng
一旦	一旦	yīdàn
多媒體	多媒体	duōméitǐ
求	求	qiú
絕對	绝对	juéduì
資料庫	资料库	zīliàokù
選舉	选举	xuǎnjǔ
不可能	不可能	bùkěnéng
馬上	马上	mǎshàng
說話	说话	shuōhuà
享受	享受	xiǎngshòu
工廠	工厂	gōngchǎng
食物	食物	shíwù
消息	消息	xiāoxí
番	番	fān
趨勢	趋势	qūshì
房子	房子	fángzi
觀點	观点	guāndiǎn
購買	购买	gòumǎi
普遍	普遍	pǔbiàn
設立	设立	shèlì
差異	差异	chāyì
差	差	chā
另外	另外	lìngwài
統一	统一	tǒngyī
青年	青年	qīngnián
統一	统一	tǒngyī
行政院	行政院	xíngzhèngyuàn
規模	规模	guīmó
股	股	gǔ
破壞	破坏	pòhuài
想要	想要	xiǎngyào
換	换	huàn
選	选	xuǎn
人力	人力	rénlì
美	美	měi
水準	水准	shuǐzhǔn
首	首	shǒu
河川	河川	héchuān
文字	文字	wénzì
立即	立即	lìjí
適當	适当	shìdàng
醫師	医师	yīshī
屬	属	shǔ
重	重	zhòng
就是說	就是说	jiùshìshuō
結婚	结婚	jiéhūn
有	有	yǒu
日子	日子	rìzi
非	非	fēi
貿易	贸易	màoyì
相當	相当	xiāngdāng
參觀	参观	cānguān
公開	公开	gōngkāi
順利	顺利	shùnlì
男	男	nán
銷售	销售	xiāoshòu
辦	办	bàn
銷售	销售	xiāoshòu
維護	维护	wéihù
投入	投入	tóurù
稱	称	chēng
加上	加上	jiāshàng
民進黨	民进党	mínjìndǎng
必	必	bì
自由	自由	zìyóu
有限	有限	yǒuxiàn
預算	预算	yūsuàn
計算	计算	jìsuàn
效率	效率	xiàolù
樣子	样子	yàngzi
訪問	访问	fǎngwèn
位於	位于	wèiyū
訪問	访问	fǎngwèn
接觸	接触	jiēchù
流行	流行	liúxíng
喔	喔	wō
股市	股市	gǔshì
召開	召开	zhàokāi
運作	运作	yùnzuò
出版	出版	chūbǎn
藉	藉	jiè
觀光	观光	guānguāng
降低	降低	jiàngdī
大約	大约	dàyuē
來源	来源	láiyuán
理由	理由	lǐyóu
不斷	不断	búduàn
一點	一点	yīdiǎn
回答	回答	huídá
青少年	青少年	qīngshàonián
基本	基本	jīběn
一般	一般	yībān
看看	看看	kànkàn
合理	合理	hélǐ
採	采	cǎi
跟	跟	gēn
生物	生物	shēngwù
中華民國	中华民国	zhōnghuámínguó
直到	直到	zhídào
叫	叫	jiào
氣	气	qì
給予	给予	gěiyǔ
中文	中文	zhōngwén
法國	法国	fàguó
答案	答案	dáàn
規定	规定	guīdìng
可能	可能	kěnéng
準備	准备	zhǔnbèi
金融	金融	jīnróng
週	週	zhōu
下	下	xià
農民	农民	nóngmín
法令	法令	fǎlìng
訊息	讯息	xùnxí
公里	公里	gōnglǐ
剛剛	刚刚	gānggāng
紅	红	hóng
較	较	jiào
聲	声	shēng
倍	倍	bèi
加	加	jiā
民主	民主	mínzhǔ
臺北	台北	táiběi
無論	无论	wúlùn
辦公室	办公室	bàngōngshì
一方面	一方面	yīfāngmiàn
良好	良好	liánghǎo
級	级	jí
遊戲	遊戏	yóuxì
道	道	dào
酒	酒	jiǔ
形象	形象	xíngxiàng
跑	跑	pǎo
選擇	选择	xuǎnzé
導致	导致	dǎozhì
提到	提到	tídào
氣氛	气氛	qìfēn
動	动	dòng
院士	院士	yuànshì
指	指	zhǐ
充分	充分	chōngfèn
現代	现代	xiàndài
必要	必要	bìyào
生態	生态	shēngtài
汽車	汽车	qìchē
例子	例子	lìzi
有點	有点	yǒudiǎn
博物館	博物馆	bówùguǎn
權力	权力	quánlì
族群	族群	zúqún
媽	妈	mā
牆	墙	qiáng
船	船	chuán
基金會	基金会	jījīnhuì
詩	诗	shī
雜誌	杂志	zázhì
生存	生存	shēngcún
且	且	qiě
天	天	tiān
小孩子	小孩子	xiǎoháizi
生存	生存	shēngcún
大樓	大楼	dàlóu
最好	最好	zuìhǎo
讀書	读书	dúshū
見到	见到	jiàndào
最佳	最佳	zuìjiā
出去	出去	chūqù
想法	想法	xiǎngfǎ
幫	帮	bāng
醫生	医生	yīshēng
堅持	坚持	jiānchí
創作	创作	chuàngzuò
廣場	广场	guǎngchǎng
成員	成员	chéngyuán
留下	留下	liúxià
森林	森林	sēnlín
算	算	suàn
顆	颗	kē
各	各	gè
男女	男女	nánnǔ
特性	特性	tèxìng
影像	影像	yǐngxiàng
遭	遭	zāo
強烈	强烈	qiángliè
欸	欸	èi
解釋	解释	jiěshì
儘管	尽管	jǐnguǎn
主動	主动	zhǔdòng
喔	喔	wō
演出	演出	yǎnchū
文章	文章	wénzhāng
理想	理想	lǐxiǎng
重大	重大	zhòngdà
腳	脚	jiǎo
演出	演出	yǎnchū
危險	危险	wéixiǎn
背景	背景	bèijǐng
不少	不少	bùshǎo
唱	唱	chàng
即將	即将	jíjiāng
大部分	大部分	dàbùfèn
通訊	通讯	tōngxùn
越來越	越来越	yuèláiyuè
考試	考试	kǎoshì
學期	学期	xuéqī
反	反	fǎn
心靈	心灵	xīnlíng
獲	获	huò
既然	既然	jìrán
設	设	shè
顧客	顾客	gùkè
家人	家人	jiārén
組	组	zǔ
紛紛	纷纷	fēnfēn
提升	提升	tíshēng
搞	搞	gǎo
提升	提升	tíshēng
隨時	随时	suíshí
譬如	譬如	pìrú
子女	子女	zǐnǔ
確定	确定	quèdìng
公平	公平	gōngpíng
視為	视为	shìwéi
技巧	技巧	jìqiǎo
接著	接着	jiēzhe
畫	画	huà
領導	领导	lǐngdǎo
小心	小心	xiǎoxīn
主辦	主办	zhǔbàn
探討	探讨	tàntǎo
赴	赴	fù
回	回	huí
探討	探讨	tàntǎo
回去	回去	huíqù
弟弟	弟弟	dìdì
風	风	fēng
小學	小学	xiǎoxué
興建	兴建	xīngjiàn
狀態	状态	zhuàngtài
支援	支援	zhīyuán
還是	还是	háishì
治療	治疗	zhìliáo
衣服	衣服	yīfú
名字	名字	míngzi
參考	参考	cānkǎo
女孩	女孩	nǔhái
男性	男性	nánxìng
教室	教室	jiàoshì
太陽	太阳	tàiyáng
在	在	zài
口	口	kǒu
陳	陈	chén
稱為	称为	chēngwéi
國民	国民	guómín
研討會	研讨会	yántǎohuì
飛機	飞机	fēijī
建築師	建筑师	jiànzhúshī
王	王	wáng
究竟	究竟	jiùjìng
花	花	huā
確實	确实	quèshí
公路	公路	gōnglù
至今	至今	zhìjīn
天下	天下	tiānxià
考量	考量	kǎoliáng
日	日	rì
管	管	guǎn
少數	少数	shǎoshù
判斷	判断	pànduàn
快	快	kuài
扮演	扮演	bànyǎn
判斷	判断	pànduàn
扮演	扮演	bànyǎn
相對	相对	xiāngduì
校方	校方	xiàofāng
早已	早已	zǎoyǐ
讀者	读者	dúzhě
大會	大会	dàhuì
工人	工人	gōngrén
數量	数量	shùliàng
材料	材料	cáiliào
建議	建议	jiànyì
特徵	特征	tèzhēng
殺	杀	shā
算是	算是	suànshì
革命	革命	gémìng
國人	国人	guórén
魚	鱼	yū
操作	操作	cāozuò
統計	统计	tǒngjì
操作	操作	cāozuò
德國	德国	déguó
顯然	显然	xiǎnrán
信心	信心	xìnxīn
放棄	放弃	fàngqì
懂	懂	dǒng
治療	治疗	zhìliáo
生活	生活	shēnghuó
分析	分析	fēnxī
忙	忙	máng
建	建	jiàn
一生	一生	yīshēng
黑	黑	hēi
小說	小说	xiǎoshuō
主席	主席	zhǔxí
政大	政大	zhèngdà
集團	集团	jítuán
報名	报名	bàomíng
理想	理想	lǐxiǎng
著名	着名	zhùmíng
道德	道德	dàodé
哪裡	哪里	nǎlǐ
消失	消失	xiāoshī
經由	经由	jīngyóu
前面	前面	qiánmiàn
遇到	遇到	yūdào
提	提	tí
叫	叫	jiào
心態	心态	xīntài
集中	集中	jízhōng
建築物	建筑物	jiànzhúwù
畫面	画面	huàmiàn
叫	叫	jiào
定	定	dìng
甚	甚	shèn
可惜	可惜	kěxí
把	把	bǎ
醫學	医学	yīxué
輸入	输入	shūrù
百	百	bǎi
輸入	输入	shūrù
型態	型态	xíngtài
道理	道理	dàolǐ
愈來愈	愈来愈	yūláiyū
色彩	色彩	sècǎi
歌	歌	gē
現實	现实	xiànshí
婚姻	婚姻	hūnyīn
地球	地球	dìqiú
指導	指导	zhǐdǎo
架構	架构	jiàgòu
進口	进口	jìnkǒu
論文	论文	lùnwén
出國	出国	chūguó
商品	商品	shāngpǐn
市長	市长	shìzhǎng
分為	分为	fēnwéi
夢	梦	mèng
以前	以前	yǐqián
恐怕	恐怕	kǒngpà
死亡	死亡	sǐwáng
哥哥	哥哥	gēgē
檔案	档案	dǎngàn
死亡	死亡	sǐwáng
滿意	满意	mǎnyì
滿	满	mǎn
可愛	可爱	kěài
上海	上海	shànghǎi
可愛	可爱	kěài
休閒	休閒	xiūxián
有趣	有趣	yǒuqù
職業	职业	zhíyè
說法	说法	shuōfǎ
英文	英文	yīngwén
緊張	紧张	jǐnzhāng
預計	预计	yūjì
兄弟	兄弟	xiōngdì
體系	体系	tǐxì
間	间	jiān
專案	专案	zhuānàn
孔子	孔子	kǒngzǐ
報導	报导	bàodǎo
一半	一半	yíbàn
疾病	疾病	jíbìng
其它	其它	qítā
外國	外国	wàiguó
牠們	牠们	tāmen
報紙	报纸	bàozhǐ
狗	狗	gǒu
協調	协调	xiétiáo
念	念	niàn
哲學	哲学	zhéxué
碰到	碰到	pèngdào
提昇	提昇	tíshēng
關於	关于	guānyū
同仁	同仁	tóngrén
深入	深入	shēnrù
漫畫	漫画	mànhuà
資金	资金	zījīn
比較	比较	bǐjiǎo
作業	作业	zuòyè
比較	比较	bǐjiǎo
想像	想像	xiǎngxiàng
短	短	duǎn
即可	即可	jíkě
西	西	xī
相	相	xiāng
位置	位置	wèizhì
錯	错	cuò
穩定	稳定	wěndìng
尋找	寻找	xúnzhǎo
鳥	鸟	niǎo
系	系	xì
如此	如此	rúcǐ
系	系	xì
穩定	稳定	wěndìng
長大	长大	zhǎngdà
促進	促进	cùjìn
人文	人文	rénwén
衝突	冲突	chōngtú
廚房	厨房	chúfáng
海外	海外	hǎiwài
表演	表演	biǎoyǎn
再度	再度	zàidù
畫	画	huà
電信	电信	diànxìn
反映	反映	fǎnyìng
北	北	běi
反映	反映	fǎnyìng
筆	笔	bǐ
近	近	jìn
障礙	障碍	zhàngài
焦點	焦点	jiāodiǎn
忽然	忽然	hūrán
到處	到处	dàochù
植物	植物	zhíwù
顯得	显得	xiǎnde
不一定	不一定	bùyīdìng
攝影	摄影	shèyǐng
隨	随	suí
概念	概念	gàiniàn
面積	面积	miànjī
為何	为何	wèihé
高達	高达	gāodá
關鍵	关键	guānjiàn
作法	作法	zuòfǎ
來到	来到	láidào
如何	如何	rúhé
來到	来到	láidào
胡適	胡适	húshì
倒	倒	dào
人人	人人	rénrén
仔細	仔细	zǐxì
原	原	yuán
成就	成就	chéngjiù
視	视	shì
行銷	行销	xíngxiāo
好幾	好几	hǎojǐ
辛苦	辛苦	xīnkǔ
年輕人	年轻人	niánqīngrén
信	信	xìn
漸漸	渐渐	jiànjiàn
真	真	zhēn
教材	教材	jiàocái
所	所	suǒ
自然	自然	zìrán
動詞	动词	dòngcí
整理	整理	zhěnglǐ
男生	男生	nánshēng
遊客	遊客	yóukè
等	等	děng
女生	女生	nǔshēng
對	对	duì
懷疑	怀疑	huáiyí
痛苦	痛苦	tòngkǔ
懷疑	怀疑	huáiyí
痛苦	痛苦	tòngkǔ
交換	交换	jiāohuàn
互動	互动	hùdòng
設置	设置	shèzhì
張	张	zhāng
設置	设置	shèzhì
留	留	liú
居住	居住	jūzhù
因應	因应	yīnyìng
丈夫	丈夫	zhàngfū
紀錄	纪录	jìlù
答	答	dá
愛	爱	ài
畫家	画家	huàjiā
數字	数字	shùzì
一向	一向	yīxiàng
連線	连线	liánxiàn
以免	以免	yǐmiǎn
固定	固定	gùdìng
通信	通信	tōngxìn
連線	连线	liánxiàn
通信	通信	tōngxìn
恢復	恢复	huīfù
修正	修正	xiūzhèng
景觀	景观	jǐngguān
線	线	xiàn
縣市	县市	xiànshì
他人	他人	tārén
恢復	恢复	huīfù
基於	基于	jīyū
只是	只是	zhǐshì
實現	实现	shíxiàn
演講	演讲	yǎnjiǎng
男子	男子	nánzǐ
實現	实现	shíxiàn
具備	具备	jùbèi
奇怪	奇怪	qíguài
空氣	空气	kōngqì
會員	会员	huìyuán
取	取	qǔ
深刻	深刻	shēnkè
漂亮	漂亮	piàoliàng
菜	菜	cài
希望	希望	xīwàng
相互	相互	xiānghù
多數	多数	duōshù
總經理	总经理	zǒngjīnglǐ
很多	很多	hěnduō
收	收	shōu
權利	权利	quánlì
照片	照片	zhàopiàn
病	病	bìng
物質	物质	wùzhí
宿舍	宿舍	sùshè
即	即	jí
教練	教练	jiàoliàn
宇宙	宇宙	yǔzhòu
更加	更加	gèngjiā
住宅	住宅	zhùzhái
明白	明白	míngbái
竟然	竟然	jìngrán
光	光	guāng
迅速	迅速	xùnsù
睡	睡	shuì
大多數	大多数	dàduōshù
不良	不良	bùliáng
自動	自动	zìdòng
哦	哦	ó
突破	突破	túpò
後面	后面	hòumiàn
污染	污染	wūrǎn
陸續	陆续	lùxù
飛	飞	fēi
內心	内心	nèixīn
女子	女子	nǔzǐ
玻璃	玻璃	bōlí
神	神	shén
中	中	zhōng
市民	市民	shìmín
承認	承认	chéngrèn
不滿	不满	bùmǎn
年齡	年龄	niánlíng
近	近	jìn
記憶	记忆	jìyì
打算	打算	dǎsuàn
應用	应用	yìngyòng
老闆	老板	lǎobǎn
成熟	成熟	chéngshú
進	进	jìn
證明	证明	zhèngmíng
國立	国立	guólì
施工	施工	shīgōng
口	口	kǒu
名	名	míng
叫做	叫做	jiàozuò
入	入	rù
包含	包含	bāohán
場所	场所	chángsuǒ
後	后	hòu
行	行	xíng
休息	休息	xiūxí
從來	从来	cónglái
東	东	dōng
要是	要是	yàoshì
適應	适应	shìyìng
工會	工会	gōnghuì
原	原	yuán
聽說	听说	tīngshuō
高級	高级	gāojí
距離	距离	jùlí
不易	不易	búyì
有沒有	有没有	yǒuméiyǒu
不易	不易	búyì
人性	人性	rénxìng
走到	走到	zǒudào
拍	拍	pāi
馬	马	mǎ
規則	规则	guīzé
以外	以外	yǐwài
關懷	关怀	guānhuái
另一方面	另一方面	lìngyīfāngmiàn
實力	实力	shílì
靠	靠	kào
假如	假如	jiǎrú
研發	研发	yánfā
攻擊	攻击	gōngjí
幹部	干部	gànbù
資格	资格	zīgé
引進	引进	yǐnjìn
做到	做到	zuòdào
吃飯	吃饭	chīfàn
保險	保险	bǎoxiǎn
發行	发行	fāxíng
壞	坏	huài
證券	证券	zhèngquàn
大幅	大幅	dàfú
還有	还有	háiyǒu
公斤	公斤	gōngjīn
性質	性质	xìngzhí
某些	某些	mǒuxiē
幸福	幸福	xìngfú
以上	以上	yǐshàng
明確	明确	míngquè
聯盟	联盟	liánméng
主持	主持	zhǔchí
一再	一再	yīzài
保育	保育	bǎoyū
師生	师生	shīshēng
立委	立委	lìwěi
改	改	gǎi
年	年	nián
保育	保育	bǎoyū
多半	多半	duōbàn
管道	管道	guǎndào
絕不	绝不	juébù
報	报	bào
認同	认同	rèntóng
一致	一致	yīzhì
最多	最多	zuìduō
股票	股票	gǔpiào
作者	作者	zuòzhě
島	岛	dǎo
細胞	细胞	xìbāo
病毒	病毒	bìngdú
衛生	卫生	wèishēng
易	易	yì
抗議	抗议	kàngyì
免費	免费	miǎnfèi
抗議	抗议	kàngyì
教育局	教育局	jiàoyūjú
哪	哪	na
農業	农业	nóngyè
管制	管制	guǎnzhì
一定	一定	yīdìng
自動化	自动化	zìdònghuà
展示	展示	zhǎnshì
情感	情感	qínggǎn
熱	热	rè
一邊	一边	yībiān
自動化	自动化	zìdònghuà
忘	忘	wàng
拒絕	拒绝	jùjué
只有	只有	zhǐyǒu
妻子	妻子	qīzǐ
行業	行业	hángyè
經理	经理	jīnglǐ
那樣	那样	nàyàng
和平	和平	hépíng
哭	哭	kū
城	城	chéng
根	根	gēn
主人	主人	zhǔrén
廠	厂	chǎng
大人	大人	dàrén
機器	机器	jīqì
不得	不得	bùdé
橋	桥	qiáo
以下	以下	yǐxià
幅	幅	fú
公分	公分	gōngfēn
失敗	失败	shībài
真實	真实	zhēnshí
主張	主张	zhǔzhāng
外面	外面	wàimiàn
首	首	shǒu
直	直	zhí
真實	真实	zhēnshí
車子	车子	chēzi
星期	星期	xīngqí
表面	表面	biǎomiàn
紐約	纽约	niǒuyuē
做法	做法	zuòfǎ
創意	创意	chuàngyì
台中	台中	táizhōng
乃	乃	nǎi
構成	构成	gòuchéng
網際	网际	wǎngjì
怎麼辦	怎么办	zěnmebàn
事務	事务	shìwù
眼前	眼前	yǎnqián
構成	构成	gòuchéng
警察	警察	jǐngchá
個性	个性	gèxìng
研究院	研究院	yánjiùyuàn
意願	意愿	yìyuàn
視訊	视讯	shìxùn
體制	体制	tǐzhì
經濟部	经济部	jīngjìbù
感受	感受	gǎnshòu
負責人	负责人	fùzérén
陽光	阳光	yángguāng
用來	用来	yònglái
修	修	xiū
機場	机场	jīchǎng
中東	中东	zhōngdōng
不用	不用	búyòng
妹妹	妹妹	mèimèi
顧問	顾问	gùwèn
上市	上市	shàngshì
退休	退休	tuìxiū
肯	肯	kěn
早	早	zǎo
權益	权益	quányì
店	店	diàn
夠	够	gòu
決定	决定	juédìng
審查	审查	shěnchá
輕	轻	qīng
處	处	chù
望	望	wàng
年紀	年纪	niánjì
交易	交易	jiāoyì
房間	房间	fángjiān
性格	性格	xìnggé
畢竟	毕竟	bìjìng
詞典	词典	cídiǎn
平衡	平衡	pínghéng
哦	哦	ó
苦	苦	kǔ
拉	拉	lā
大小	大小	dàxiǎo
佳	佳	jiā
保留	保留	bǎoliú
玩具	玩具	wánjù
密切	密切	mìqiè
不過	不过	búguò
打開	打开	dǎkāi
南	南	nán
亂	乱	luàn
予以	予以	yūyǐ
供應	供应	gōngyìng
文明	文明	wénmíng
按	按	àn
相處	相处	xiāngchǔ
供應	供应	gōngyìng
相處	相处	xiāngchǔ
消費	消费	xiāofèi
激烈	激烈	jīliè
付出	付出	fùchū
競爭	竞争	jìngzhēng
基金	基金	jījīn
好處	好处	hǎochù
作家	作家	zuòjiā
若是	若是	ruòshì
金錢	金钱	jīnqián
落實	落实	luòshí
現有	现有	xiànyǒu
等於	等于	děngyū
懂得	懂得	dǒngde
改進	改进	gǎijìn
分配	分配	fēnpèi
購物	购物	gòuwù
世紀	世纪	shìjì
共識	共识	gòngshì
分配	分配	fēnpèi
航空	航空	hángkōng
累積	累积	lěijī
法規	法规	fǎguī
程序	程序	chéngxù
購物	购物	gòuwù
貢獻	贡献	gòngxiàn
特質	特质	tèzhí
任務	任务	rènwù
民意	民意	mínyì
輕鬆	轻松	qīngsōng
軍事	军事	jūnshì
野生	野生	yěshēng
道	道	dào
形容	形容	xíngróng
展現	展现	zhǎnxiàn
挑戰	挑战	tiǎozhàn
河	河	hé
起	起	qǐ
滿	满	mǎn
輛	辆	liàng
球	球	qiú
同	同	tóng
其次	其次	qícì
統治	统治	tǒngzhì
跳	跳	tiào
嚴格	严格	yángé
想起	想起	xiǎngqǐ
樓	楼	lóu
投資人	投资人	tóuzīrén
修改	修改	xiūgǎi
幫忙	帮忙	bāngmáng
類型	类型	lèixíng
波	波	bō
毛	毛	máo
飯店	饭店	fàndiàn
超越	超越	chāoyuè
雨	雨	yǔ
必要	必要	bìyào
旁邊	旁边	pángbiān
依然	依然	yīrán
看出	看出	kànchū
旅行	旅行	lǔxíng
熟悉	熟悉	shóuxī
不同	不同	bùtóng
抓	抓	zhuā
餐廳	餐厅	cāntīng
不妨	不妨	bùfáng
平等	平等	píngděng
困難	困难	kùnnán
顏色	颜色	yánsè
談到	谈到	tándào
彈性	弹性	tánxìng
從此	从此	cóngcǐ
哈	哈	hā
待	待	dài
硬體	硬体	yìngtǐ
種子	种子	zhǒngzi
份子	份子	fènzǐ
命運	命运	mìngyùn
看起來	看起来	kànqǐlái
規範	规范	guīfàn
演奏	演奏	yǎnzòu
癌症	癌症	yánzhèng
藝術家	艺术家	yìshùjiā
過	过	guò
得以	得以	déyǐ
日本人	日本人	rìběnrén
街	街	jiē
極為	极为	jíwéi
先進	先进	xiānjìn
難道	难道	nándào
出發	出发	chūfā
市府	市府	shìfǔ
諮詢	谘询	zīxún
嘴	嘴	zuǐ
諮詢	谘询	zīxún
陪	陪	péi
停	停	tíng
連接	连接	liánjiē
外交	外交	wàijiāo
營業	营业	yíngyè
期待	期待	qídài
罵	骂	mà
期待	期待	qídài
授權	授权	shòuquán
面前	面前	miànqián
始終	始终	shǐzhōng
理解	理解	lǐjiě
正好	正好	zhènghǎo
多麼	多么	duóme
澳洲	澳洲	àozhōu
理解	理解	lǐjiě
特定	特定	tèdìng
縣長	县长	xiànzhǎng
認真	认真	rènzhēn
樂團	乐团	yuètuán
認真	认真	rènzhēn
主力	主力	zhǔlì
福利	福利	fúlì
不得不	不得不	bùdébù
生意	生意	shēngyì
情	情	qíng
從小	从小	cóngxiǎo
展出	展出	zhǎnchū
看看	看看	kànkàn
取代	取代	qǔdài
全面	全面	quánmiàn
名稱	名称	míngchēng
隊	队	duì
派	派	pài
華人	华人	huárén
藉由	藉由	jièyóu
生氣	生气	shēngqì
縣府	县府	xiànfǔ
衝擊	冲击	chōngjí
資產	资产	zīchǎn
試	试	shì
發出	发出	fāchū
毫無	毫无	háowú
停止	停止	tíngzhǐ
基地	基地	jīdì
感動	感动	gǎndòng
矛盾	矛盾	máodùn
藥物	药物	yàowù
不幸	不幸	búxìng
矛盾	矛盾	máodùn
改造	改造	gǎizào
感覺	感觉	gǎnjué
董事長	董事长	dǒngshìzhǎng
競爭力	竞争力	jìngzhēnglì
中間	中间	zhōngjiān
毛澤東	毛泽东	máozédōng
痛	痛	tòng
採購	采购	cǎigòu
堆	堆	duī
蛇	蛇	shé
有意	有意	yǒuyì
估計	估计	gūjì
層次	层次	céngcì
主導	主导	zhǔdǎo
足夠	足够	zúgòu
林	林	lín
飯	饭	fàn
號	号	hào
親自	亲自	qīnzì
主導	主导	zhǔdǎo
等到	等到	děngdào
便宜	便宜	piányí
更為	更为	gèngwéi
天空	天空	tiānkōng
反彈	反弹	fǎntán
似	似	sì
些	些	xiē
爸	爸	bà
訓練	训练	xùnliàn
尋求	寻求	xúnqiú
反彈	反弹	fǎntán
手法	手法	shǒufǎ
私人	私人	sīrén
光碟	光碟	guāngdié
立法院	立法院	lìfǎyuàn
組合	组合	zǔhé
稍	稍	shāo
層面	层面	céngmiàn
中研院	中研院	zhōngyányuàn
困擾	困扰	kùnrǎo
熱鬧	热闹	rènào
日後	日后	rìhòu
實	实	shí
熱鬧	热闹	rènào
喜愛	喜爱	xǐài
時	时	shí
美好	美好	měihǎo
機車	机车	jīchē
韓國	韩国	hánguó
收入	收入	shōurù
議員	议员	yìyuán
衛星	卫星	wèixīng
勝	胜	shèng
註	注	zhù
徹底	彻底	chèdǐ
預定	预定	yūdìng
房屋	房屋	fángwū
提醒	提醒	tíxǐng
蓋	盖	gài
營運	营运	yíngyùn
提醒	提醒	tíxǐng
所在	所在	suǒzài
詳細	详细	xiángxì
蓋	盖	gài
結論	结论	jiélùn
反正	反正	fǎnzhèng
牛	牛	niú
右	右	yòu
廣泛	广泛	guǎngfàn
愉快	愉快	yūkuài
陣	阵	zhèn
愉快	愉快	yūkuài
優勢	优势	yōushì
流程	流程	liúchéng
搭	搭	dā
階級	阶级	jiējí
境界	境界	jìngjiè
大部份	大部份	dàbùfèn
限制	限制	xiànzhì
連續	连续	liánxù
客人	客人	kèrén
秩序	秩序	zhìxù
力	力	lì
這兒	这儿	zhèēr
養	养	yǎng
保守	保守	bǎoshǒu
過去	过去	guòqù
市立	市立	shìlì
引發	引发	yǐnfā
東方	东方	dōngfāng
大盤	大盘	dàpán
奧會	奥会	àohuì
財務	财务	cáiwù
經歷	经历	jīnglì
面	面	miàn
錯誤	错误	cuòwù
爺爺	爷爷	yéyé
國會	国会	guóhuì
差距	差距	chājù
傷害	伤害	shānghài
委託	委讬	wěituō
之所以	之所以	zhīsuǒyǐ
台	台	tái
趕快	赶快	gǎnkuài
移民	移民	yímín
商店	商店	shāngdiàn
委託	委讬	wěituō
投票	投票	tóupiào
同事	同事	tóngshì
進而	进而	jìnér
將軍	将军	jiāngjūn
球員	球员	qiúyuán
原來	原来	yuánlái
冷	冷	lěng
感染	感染	gǎnrǎn
導演	导演	dǎoyǎn
人間	人间	rénjiān
古	古	gǔ
感染	感染	gǎnrǎn
財產	财产	cáichǎn
分享	分享	fēnxiǎng
遺址	遗址	yízhǐ
發覺	发觉	fājué
造型	造型	zàoxíng
一面	一面	yīmiàn
分享	分享	fēnxiǎng
不只	不只	bùzhǐ
不禁	不禁	bùjīn
打破	打破	dǎpò
忽略	忽略	hūluè
原有	原有	yuányǒu
草案	草案	cǎoàn
害怕	害怕	hàipà
身為	身为	shēnwéi
性能	性能	xìngnéng
活潑	活泼	huópō
記錄	记录	jìlù
清華	清华	qīnghuá
綜合	综合	zònghé
講話	讲话	jiǎnghuà
儘量	尽量	jǐnliàng
違反	违反	wéifǎn
偉大	伟大	wěidà
金額	金额	jīné
功課	功课	gōngkè
偉大	伟大	wěidà
場地	场地	chǎngdì
龐大	庞大	pángdà
市區	市区	shìqū
巴黎	巴黎	bālí
反省	反省	fǎnxǐng
主角	主角	zhǔjiǎo
理事長	理事长	lǐshìzhǎng
背後	背后	bèihòu
龐大	庞大	pángdà
反省	反省	fǎnxǐng
犧牲	牺牲	xīshēng
天	天	tiān
蠻	蛮	mán
以便	以便	yǐbiàn
犧牲	牺牲	xīshēng
預防	预防	yūfáng
爭	争	zhēng
種類	种类	zhǒnglèi
預防	预防	yūfáng
就業	就业	jiùyè
本土	本土	běntǔ
天氣	天气	tiānqì
夫妻	夫妻	fūqī
左	左	zuǒ
優點	优点	yōudiǎn
嗯哼	嗯哼	ēnhēng
就業	就业	jiùyè
事物	事物	shìwù
困境	困境	kùnjìng
呼籲	呼籲	hūyū
據說	据说	jùshuō
人事	人事	rénshì
大學生	大学生	dàxuéshēng
洗	洗	xǐ
農村	农村	nóngcūn
數學	数学	shùxué
女士	女士	nǔshì
風氣	风气	fēngqì
必然	必然	bìrán
難得	难得	nándé
樂器	乐器	yuèqì
果然	果然	guǒrán
安非他命	安非他命	ānfēitāmìng
床	床	chuáng
局	局	jú
指	指	zhǐ
戲	戏	xì
除非	除非	chúfēi
訂	订	dìng
研究員	研究员	yánjiùyuán
唉	唉	āi
著手	着手	zhuóshǒu
熱烈	热烈	rèliè
按	按	àn
能源	能源	néngyuán
其餘	其余	qíyū
找出	找出	zhǎochū
影片	影片	yǐngpiàn
白色	白色	báisè
可以	可以	kěyǐ
等待	等待	děngdài
創作	创作	chuàngzuò
等待	等待	děngdài
年度	年度	niándù
慢	慢	màn
缺點	缺点	quēdiǎn
接近	接近	jiējìn
數據	数据	shùjù
缺	缺	quē
中	中	zhōng
條例	条例	tiáolì
藥	药	yào
報告	报告	bàogào
身邊	身边	shēnbiān
改為	改为	gǎiwéi
指標	指标	zhǐbiāo
沿	沿	yán
設定	设定	shèdìng
眼光	眼光	yǎnguāng
設定	设定	shèdìng
聰明	聪明	cōngmíng
下列	下列	xiàliè
打電話	打电话	dǎdiànhuà
舉	举	jǔ
醫學院	医学院	yīxuéyuàn
參考	参考	cānkǎo
大自然	大自然	dàzìrán
騎	骑	qí
人際	人际	rénjì
漢人	汉人	hànrén
剩下	剩下	shèngxià
傳播	传播	chuánbò
自從	自从	zìcóng
傳播	传播	chuánbò
冠軍	冠军	guànjūn
學會	学会	xuéhuì
海洋	海洋	hǎiyáng
彷彿	彷彿	fǎngfú
東京	东京	dōngjīng
負擔	负担	fùdān
知名	知名	zhīmíng
那兒	那儿	nǎēr
爭議	争议	zhēngyì
實質	实质	shízhí
查詢	查询	cháxún
校務	校务	xiàowù
部隊	部队	bùduì
火車	火车	huǒchē
幼稚園	幼稚园	yòuzhìyuán
話題	话题	huàtí
感謝	感谢	gǎnxiè
獎金	奖金	jiǎngjīn
大師	大师	dàshī
聯絡	联络	liánluò
原始	原始	yuánshǐ
北市	北市	běishì
課題	课题	kètí
路線	路线	lùxiàn
信仰	信仰	xìnyǎng
英雄	英雄	yīngxióng
契約	契约	qìyuē
訂定	订定	dìngdìng
批評	批评	pīpíng
法院	法院	fǎyuàn
訂定	订定	dìngdìng
愛情	爱情	àiqíng
依據	依据	yījù
適用	适用	shìyòng
學位	学位	xuéwèi
水庫	水库	shuǐkù
千	千	qiān
民主	民主	mínzhǔ
贊成	赞成	zànchéng
好奇	好奇	hàoqí
科威特	科威特	kēwēitè
體會	体会	tǐhuì
熊貓	熊猫	xióngmāo
暫時	暂时	zhànshí
萬	万	wàn
較為	较为	jiàowéi
單純	单纯	dānchún
透露	透露	tòulù
品牌	品牌	pǐnpái
候選人	候选人	hòuxuǎnrén
單純	单纯	dānchún
看來	看来	kànlái
內涵	内涵	nèihán
登記	登记	dēngjì
棵	棵	kē
會長	会长	huìzhǎng
核心	核心	héxīn
家具	家具	jiājù
座談會	座谈会	zuòtánhuì
症狀	症状	zhèngzhuàng
火	火	huǒ
一帶	一带	yīdài
患者	患者	huànzhě
很少	很少	hěnshǎo
有名	有名	yǒumíng
依照	依照	yīzhào
忘記	忘记	wàngjì
小型	小型	xiǎoxíng
占	占	zhàn
手段	手段	shǒuduàn
優秀	优秀	yōuxiù
倒是	倒是	dàoshì
明星	明星	míngxīng
吸收	吸收	xīshōu
人格	人格	réngé
指數	指数	zhǐshù
做好	做好	zuòhǎo
動態	动态	dòngtài
游泳	游泳	yóuyǒng
不如	不如	bùrú
出生	出生	chūshēng
遂	遂	suì
當作	当作	dāngzuò
會	会	huì
學問	学问	xuéwèn
嘗試	尝试	chángshì
全民	全民	quánmín
部落	部落	bùluò
賺	赚	zhuàn
聯合國	联合国	liánhéguó
擺	摆	bǎi
賺錢	赚钱	zhuànqián
與會	与会	yǔhuì
鳥類	鸟类	niǎolèi
答應	答应	dāyìng
掛	挂	guà
石頭	石头	shítou
挫折	挫折	cuòzhé
飛行	飞行	fēixíng
行程	行程	xíngchéng
理性	理性	lǐxìng
夫人	夫人	fūrén
累	累	lèi
轉變	转变	zhuǎnbiàn
本質	本质	běnzhí
上班	上班	shàngbān
興奮	兴奋	xīngfèn
那邊	那边	nàbiān
興奮	兴奋	xīngfèn
帶動	带动	dàidòng
急	急	jí
帶動	带动	dàidòng
捷運	捷运	jiéyùn
諸	诸	zhū
廣	广	guǎng
慶祝	庆祝	qìngzhù
司機	司机	sījī
難過	难过	nánguò
高雄市	高雄市	gāoxióngshì
習慣	习惯	xíguàn
出席	出席	chūxí
外界	外界	wàijiè
女孩子	女孩子	nǔháizi
語法	语法	yǔfǎ
頁	页	yè
閱讀	阅读	yuèdú
頭	头	tóu
借	借	jiè
拍攝	拍摄	pāishè
家族	家族	jiāzú
身心	身心	shēnxīn
專門	专门	zhuānmén
可憐	可怜	kělián
舞蹈	舞蹈	wǔdào
味道	味道	wèidào
個案	个案	gèàn
事先	事先	shìxiān
大專	大专	dàzhuān
下面	下面	xiàmiàn
下	下	xià
練習	练习	liànxí
就算	就算	jiùsuàn
南非	南非	nánfēi
表情	表情	biǎoqíng
耶	耶	yé
藉著	藉着	jièzhe
以致	以致	yǐzhì
自殺	自杀	zìshā
助理	助理	zhùlǐ
自殺	自杀	zìshā
洞	洞	dòng
測試	测试	cèshì
臺北市	台北市	táiběishì
歐美	欧美	ōuměi
獎勵	奖励	jiǎnglì
杯	杯	bēi
體驗	体验	tǐyàn
浪費	浪费	làngfèi
體驗	体验	tǐyàn
個人電腦	个人电脑	geréndiànnǎo
本人	本人	běnrén
口	口	kǒu
質疑	质疑	zhíyí
血液	血液	xiěyè
走向	走向	zǒuxiàng
形態	形态	xíngtài
步驟	步骤	bùzòu
視覺	视觉	shìjué
正面	正面	zhèngmiàn
收費	收费	shōufèi
促使	促使	cùshǐ
補助	补助	bǔzhù
階層	阶层	jiēcéng
期望	期望	qíwàng
實驗室	实验室	shíyànshì
皮膚	皮肤	pífū
病患	病患	bìnghuàn
武器	武器	wǔqì
日益	日益	rìyì
大都	大都	dàdōu
獎	奖	jiǎng
檢討	检讨	jiǎntǎo
螢幕	萤幕	yíngmù
檢討	检讨	jiǎntǎo
禁止	禁止	jìnzhǐ
起來	起来	qǐlái
輔大	辅大	fǔdà
旅客	旅客	lǔkè
繪畫	绘画	huìhuà
用	用	yòng
生	生	shēng
腳步	脚步	jiǎobù
設計師	设计师	shèjìshī
救	救	jiù
納入	纳入	nàrù
南部	南部	nánbù
害	害	hài
計程車	计程车	jìchéngchē
光	光	guāng
貴	贵	guì
現代化	现代化	xiàndàihuà
破	破	pò
吹	吹	chuī
勇氣	勇气	yǒngqì
現代化	现代化	xiàndàihuà
氣候	气候	qìhòu
化學	化学	huàxué
巴西	巴西	bāxī
人權	人权	rénquán
這麼多	这么多	zhèmeduō
生涯	生涯	shēngyá
文件	文件	wénjiàn
簡直	简直	jiǎnzhí
導向	导向	dǎoxiàng
儀式	仪式	yíshì
用途	用途	yòngtú
生長	生长	shēngzhǎng
舞台	舞台	wǔtái
逢	逢	féng
生長	生长	shēngzhǎng
義工	义工	yìgōng
科學家	科学家	kēxuéjiā
業主	业主	yèzhǔ
軍隊	军队	jūnduì
各自	各自	gèzì
如果說	如果说	rúguǒshuō
案件	案件	ànjiàn
爆發	爆发	bàofā
有如	有如	yǒurú
各界	各界	gèjiè
題目	题目	tímù
街頭	街头	jiētóu
寬	宽	kuān
有如	有如	yǒurú
爆發	爆发	bàofā
底	底	dǐ
決策	决策	juécè
抱	抱	bào
故宮	故宫	gùgōng
傑出	杰出	jiéchū
窗	窗	chuāng
說明	说明	shuōmíng
糧食	粮食	liángshí
固然	固然	gùrán
變遷	变迁	biànqiān
議題	议题	yìtí
凡	凡	fán
太多	太多	tàiduō
民俗	民俗	mínsú
唱片	唱片	chàngpiàn
實驗	实验	shíyàn
處於	处于	chǔyū
效益	效益	xiàoyì
古典	古典	gǔdiǎn
構想	构想	gòuxiǎng
期望	期望	qíwàng
推薦	推荐	tuījiàn
收集	收集	shōují
推薦	推荐	tuījiàn
命	命	mìng
車輛	车辆	chēliàng
收集	收集	shōují
實踐	实践	shíjiàn
商人	商人	shāngrén
華航	华航	huáháng
頭髮	头发	tóufǎ
實踐	实践	shíjiàn
描述	描述	miáoshù
潮流	潮流	cháoliú
若干	若干	ruògān
方	方	fāng
台灣人	台湾人	táiwānrén
領袖	领袖	lǐngxiù
眾多	众多	zhòngduō
故意	故意	gùyì
和諧	和谐	héxié
取締	取缔	qǔdì
抽	抽	chōu
大地	大地	dàdì
大門	大门	dàmén
追	追	zhuī
性別	性别	xìngbié
邀	邀	yāo
入學	入学	rùxué
傷害	伤害	shānghài
更新	更新	gēngxīn
呈	呈	chéng
更新	更新	gēngxīn
中學	中学	zhōngxué
吳	吴	wú
保障	保障	bǎozhàng
書籍	书籍	shūjí
四周	四周	sìzhōu
客觀	客观	kèguān
戶	户	hù
檢驗	检验	jiǎnyàn
蒐集	蒐集	sōují
檢驗	检验	jiǎnyàn
獨特	独特	dútè
無奈	无奈	wúnài
肉	肉	ròu
無限	无限	wúxiàn
觀賞	观赏	guānshǎng
可能性	可能性	kěnéngxìng
無奈	无奈	wúnài
現代人	现代人	xiàndàirén
情勢	情势	qíngshì
推展	推展	tuīzhǎn
師大	师大	shīdà
宣布	宣布	xuānbù
律師	律师	lùshī
宣布	宣布	xuānbù
波斯灣	波斯湾	pōsīwān
飲食	饮食	yǐnshí
睡覺	睡觉	shuìjiào
空	空	kòng
聯合	联合	liánhé
可見	可见	kějiàn
訪	访	fǎng
電力	电力	diànlì
失望	失望	shīwàng
鄉	乡	xiāng
旅館	旅馆	lǔguǎn
政黨	政党	zhèngdǎng
取消	取消	qǔxiāo
地面	地面	dìmiàn
防止	防止	fángzhǐ
取消	取消	qǔxiāo
言論	言论	yánlùn
差別	差别	chābié
失望	失望	shīwàng
建造	建造	jiànzào
代價	代价	dàijià
戴	戴	dài
跟	跟	gēn
常見	常见	chángjiàn
房地產	房地产	fángdìchǎn
食品	食品	shípǐn
個別	个别	gèbié
建造	建造	jiànzào
來賓	来宾	láibīn
重複	重复	chóngfù
兼	兼	jiān
意外	意外	yìwài
秒	秒	miǎo
全體	全体	quántǐ
方	方	fāng
沒想到	没想到	méixiǎngdào
足以	足以	zúyǐ
損失	损失	sǔnshī
當場	当场	dāngcháng
舒服	舒服	shūfú
憑	凭	píng
手術	手术	shǒushù
之內	之内	zhīnèi
信任	信任	xìnrèn
血	血	xiě
信任	信任	xìnrèn
公務員	公务员	gōngwùyuán
浪漫	浪漫	làngmàn
業界	业界	yèjiè
棟	栋	dòng
暴力	暴力	bàolì
腿	腿	tuǐ
充實	充实	chōngshí
公會	公会	gōnghuì
也就是說	也就是说	yějiùshìshuō
升級	升级	shēngjí
指示	指示	zhǐshì
充實	充实	chōngshí
古蹟	古蹟	gǔjī
還	还	hái
緊急	紧急	jǐnjí
創業	创业	chuàngyè
新竹市	新竹市	xīnzhúshì
創業	创业	chuàngyè
裡頭	里头	lǐtóu
基因	基因	jīyīn
崇拜	崇拜	chóngbài
風景	风景	fēngjǐng
也好	也好	yěhǎo
日期	日期	rìqí
佛教	佛教	fójiào
一一	一一	yīyī
當局	当局	dāngjú
進	进	jìn
格式	格式	géshì
北部	北部	běibù
吸食	吸食	xīshí
天天	天天	tiāntiān
現況	现况	xiànkuàng
紙	纸	zhǐ
貨	货	huò
相反	相反	xiāngfǎn
按照	按照	ànzhào
特	特	tè
吸食	吸食	xīshí
見面	见面	jiànmiàn
發動	发动	fādòng
公頃	公顷	gōngqīng
主機	主机	zhǔjī
隨便	随便	suíbiàn
資本	资本	zīběn
發動	发动	fādòng
裝	装	zhuāng
走進	走进	zǒujìn
分類	分类	fēnlèi
別	别	bié
泰國	泰国	tàiguó
倫敦	伦敦	lúndūn
秘書	秘书	mìshū
部屬	部属	bùshǔ
高度	高度	gāodù
問卷	问卷	wènjuàn
乾淨	干净	gānjìng
肝炎	肝炎	gānyán
來臨	来临	láilín
胡	胡	hú
保證	保证	bǎozhèng
能否	能否	néngfǒu
肚子	肚子	dùzi
地震	地震	dìzhèn
指定	指定	zhǐdìng
時常	时常	shícháng
民營	民营	mínyíng
確保	确保	quèbǎo
新台幣	新台币	xīntáibì
喊	喊	hǎn
途徑	途径	tújìng
民營	民营	mínyíng
一路	一路	yīlù
輸出	输出	shūchū
敏感	敏感	mǐngǎn
溫暖	温暖	wēnnuǎn
可怕	可怕	kěpà
生理	生理	shēnglǐ
月亮	月亮	yuèliàng
輸出	输出	shūchū
癌	癌	yán
溫暖	温暖	wēnnuǎn
動機	动机	dòngjī
連	连	lián
帶領	带领	dàilǐng
東南亞	东南亚	dōngnányǎ
印表機	印表机	yìnbiǎojī
成分	成分	chéngfèn
據了解	据了解	jùliǎojiě
儒家	儒家	rújiā
可怕	可怕	kěpà
教育	教育	jiàoyū
設法	设法	shèfǎ
儲存	储存	chúcún
搭配	搭配	dāpèi
傳輸	传输	chuánshū
離	离	lí
圖書	图书	túshū
搭配	搭配	dāpèi
高科技	高科技	gāokējì
治	治	zhì
門口	门口	ménkǒu
外在	外在	wàizài
儲存	储存	chúcún
符號	符号	fúhào
風貌	风貌	fēngmào
名詞	名词	míngcí
合併	合并	hébìng
利潤	利润	lìrùn
合併	合并	hébìng
搶	抢	qiǎng
幹	干	gàn
無數	无数	wúshù
奧運	奥运	àoyùn
就	就	jiù
句子	句子	jùzi
娛樂	娱乐	yúlè
百貨	百货	bǎihuò
分子	分子	fènzǐ
厲害	厉害	lìhài
零	零	líng
厲害	厉害	lìhài
殘障	残障	cánzhàng
國語	国语	guóyǔ
少女	少女	shàonǔ
作	作	zuò
教堂	教堂	jiàotáng
許	许	xǔ
風險	风险	fēngxiǎn
教科書	教科书	jiàokēshū
黑色	黑色	hēisè
資深	资深	zīshēn
就讀	就读	jiùdú
曉得	晓得	xiǎode
請問	请问	qǐngwèn
增進	增进	zēngjìn
贏得	赢得	yíngdé
犯罪	犯罪	fànzuì
台幣	台币	táibì
犯罪	犯罪	fànzuì
偶爾	偶尔	ǒuěr
培訓	培训	péixùn
譬如說	譬如说	pìrúshuō
上帝	上帝	shàngdì
種	种	zhòng
輩子	辈子	bèizi
筆者	笔者	bǐzhě
喪失	丧失	sàngshī
部長	部长	bùzhǎng
寂寞	寂寞	jímò
培訓	培训	péixùn
設有	设有	shèyǒu
情報	情报	qíngbào
前來	前来	qiánlái
飛彈	飞弹	fēidàn
虎	虎	hǔ
寂寞	寂寞	jímò
專題	专题	zhuāntí
排名	排名	páimíng
怎樣	怎样	zěnyàng
案例	案例	ànlì
傳送	传送	chuánsòng
排名	排名	páimíng
允許	允许	yǔnxǔ
認定	认定	rèndìng
威脅	威胁	wēixié
大聲	大声	dàshēng
傳送	传送	chuánsòng
當做	当做	dāngzuò
經銷商	经销商	jīngxiāoshāng
將近	将近	jiāngjìn
戰	战	zhàn
愛心	爱心	àixīn
回國	回国	huíguó
跑到	跑到	pǎodào
過來	过来	guòlái
印度	印度	yìndù
音	音	yīn
待遇	待遇	dàiyū
開會	开会	kāihuì
身分	身分	shēnfèn
存	存	cún
留學	留学	liúxué
重要性	重要性	zhòngyàoxìng
時機	时机	shíjī
國科會	国科会	guókēhuì
時刻	时刻	shíkè
節	节	jié
開會	开会	kāihuì
遭到	遭到	zāodào
不已	不已	bùyǐ
中油	中油	zhōngyóu
景氣	景气	jǐngqì
補充	补充	bǔchōng
公主	公主	gōngzhǔ
千萬	千万	qiānwàn
公布	公布	gōngbù
豬	猪	zhū
潛力	潜力	qiánlì
黃金	黄金	huángjīn
單元	单元	dānyuán
街道	街道	jiēdào
略	略	luè
財產權	财产权	cáichǎnquán
地理	地理	dìlǐ
周	周	zhōu
到達	到达	dàodá
電信局	电信局	diànxìnjú
促銷	促销	cùxiāo
工程師	工程师	gōngchéngshī
確實	确实	quèshí
遠距	远距	yuǎnjù
驚人	惊人	jīngrén
為	为	wèi
促銷	促销	cùxiāo
彩色	彩色	cǎisè
真理	真理	zhēnlǐ
宣佈	宣佈	xuānbù
變動	变动	biàndòng
點	点	diǎn
市政府	市政府	shìzhèngfǔ
躺	躺	tǎng
漸	渐	jiàn
普通	普通	pǔtōng
進來	进来	jìnlái
涉及	涉及	shèjí
保護區	保护区	bǎohùqū
版本	版本	bǎnběn
制定	制定	zhìdìng
定義	定义	dìngyì
事項	事项	shìxiàng
法則	法则	fǎzé
否認	否认	fǒurèn
抱怨	抱怨	bàoyuàn
宜蘭	宜兰	yílán
人群	人群	rénqún
廣大	广大	guǎngdà
鄰居	邻居	línjū
模型	模型	móxíng
忍不住	忍不住	rěnbúzhù
現行	现行	xiànxíng
瓷器	瓷器	cíqì
荷蘭	荷兰	hélán
家鄉	家乡	jiāxiāng
前途	前途	qiántú
花蓮	花莲	huālián
含	含	hán
合約	合约	héyuē
官方	官方	guānfāng
成效	成效	chéngxiào
克服	克服	kèfú
循環	循环	xúnhuán
新鮮	新鲜	xīnxiān
和解	和解	héjiě
原先	原先	yuánxiān
金	金	jīn
油	油	yóu
臺	台	tái
巨大	巨大	jùdà
公車	公车	gōngchē
傳說	传说	chuánshuō
動力	动力	dònglì
推行	推行	tuīxíng
雞	鸡	jī
回應	回应	huíyìng
介入	介入	jièrù
內在	内在	nèizài
人體	人体	réntǐ
介入	介入	jièrù
謂	谓	wèi
臺大	台大	táidà
確	确	què
能	能	néng
美術	美术	měishù
活力	活力	huólì
致	致	zhì
活動	活动	huódòng
完	完	wán
那麼多	那么多	nàmeduō
物理	物理	wùlǐ
推行	推行	tuīxíng
終	终	zhōng
分成	分成	fēnchéng
台中市	台中市	táizhōngshì
代理	代理	dàilǐ
樂趣	乐趣	lèqù
超級	超级	chāojí
勞動	劳动	láodòng
唯有	唯有	wéiyǒu
宣傳	宣传	xuānchuán
交給	交给	jiāogěi
受傷	受伤	shòushāng
講師	讲师	jiǎngshī
抵達	抵达	dǐdá
體重	体重	tǐzhòng
不見得	不见得	bújiàndé
領導	领导	lǐngdǎo
蝸牛	蜗牛	guānióu
群眾	群众	qúnzhòng
抵達	抵达	dǐdá
刻意	刻意	kèyì
李登輝	李登辉	lǐdēnghuī
合作社	合作社	hézuòshè
印尼	印尼	yìnní
規格	规格	guīgé
價值觀	价值观	jiàzhíguān
依賴	依赖	yīlài
百貨公司	百货公司	bǎihuògōngsī
負擔	负担	fùdān
封	封	fēng
馬路	马路	mǎlù
通知	通知	tōngzhī
普及	普及	pǔjí
坪	坪	píng
綠	绿	lù
不安	不安	bùān
鐵路	铁路	tiělù
普及	普及	pǔjí
錄影帶	录影带	lùyǐngdài
局面	局面	júmiàn
團隊	团队	tuánduì
優先	优先	yōuxiān
對	对	duì
進去	进去	jìnqù
黃	黄	huáng
神經	神经	shénjīng
近來	近来	jìnlái
英語	英语	yīngyǔ
刺激	刺激	cìjī
羊	羊	yáng
老虎	老虎	lǎohǔ
所得	所得	suǒdé
健全	健全	jiànquán
邊	边	biān
主體	主体	zhǔtǐ
大致	大致	dàzhì
對手	对手	duìshǒu
還要	还要	háiyào
健全	健全	jiànquán
建構	建构	jiàngòu
星星	星星	xīngxīng
建構	建构	jiàngòu
大哥	大哥	dàgē
培育	培育	péiyū
用心	用心	yòngxīn
書記	书记	shūjì
財政部	财政部	cáizhèngbù
培育	培育	péiyū
遊行	遊行	yóuxíng
行	行	xíng
太平洋	太平洋	tàipíngyáng
造	造	zào
咖啡	咖啡	kāfēi
名單	名单	míngdān
注重	注重	zhùzhòng
周圍	周围	zhōuwéi
主權	主权	zhǔquán
水泥	水泥	shuǐní
近	近	jìn
合法	合法	héfǎ
便利	便利	biànlì
落後	落后	luòhòu
詢問	询问	xúnwèn
送給	送给	sònggěi
惟	惟	wéi
表	表	biǎo
糾紛	纠纷	jiūfēn
空中	空中	kōngzhōng
過於	过于	guòyū
任	任	rèn
晚	晚	wǎn
車站	车站	chēzhàn
有助於	有助于	yǒuzhùyū
便利	便利	biànlì
落後	落后	luòhòu
之類	之类	zhīlèi
下降	下降	xiàjiàng
手續	手续	shǒuxù
轉換	转换	zhuǎnhuàn
立法	立法	lìfǎ
刀	刀	dāo
帶給	带给	dàigěi
涵蓋	涵盖	hángài
差不多	差不多	chābùduō
主持人	主持人	zhǔchírén
完工	完工	wángōng
里	里	lǐ
楊	杨	yáng
內政部	内政部	nèizhèngbù
躲	躲	duǒ
美術館	美术馆	měishùguǎn
領先	领先	lǐngxiān
不當	不当	búdàng
用地	用地	yòngdì
認知	认知	rènzhī
基層	基层	jīcéng
做出	做出	zuòchū
政權	政权	zhèngquán
甚麼	什么	shéme
風景區	风景区	fēngjǐngqū
季節	季节	jìjié
享有	享有	xiǎngyǒu
對不起	对不起	duìbùqǐ
建設	建设	jiànshè
出口	出口	chūkǒu
引導	引导	yǐndǎo
實行	实行	shíxíng
錯誤	错误	cuòwù
國內外	国内外	guónèiwài
迄	迄	qì
神話	神话	shénhuà
盡	尽	jìn
花園	花园	huāyuán
非洲	非洲	fēizhōu
組織	组织	zǔzhī
音樂會	音乐会	yīnyuèhuì
繼	继	jì
預估	预估	yūgū
著作	著作	zhùzuò
感受到	感受到	gǎnshòudào
保障	保障	bǎozhàng
自主	自主	zìzhǔ
好多	好多	hǎoduō
自主	自主	zìzhǔ
姑娘	姑娘	gūniáng
財團	财团	cáituán
預期	预期	yūqí
安定	安定	āndìng
上升	上升	shàngshēng
未必	未必	wèibì
噸	吨	dùn
模擬	模拟	mónǐ
發言	发言	fāyán
底下	底下	dǐxià
安定	安定	āndìng
模擬	模拟	mónǐ
票	票	piào
出門	出门	chūmén
輔助	辅助	fǔzhù
傾向	倾向	qīngxiàng
過年	过年	guònián
照	照	zhào
廟	庙	miào
幫	帮	bāng
人工	人工	réngōng
禮	礼	lǐ
信	信	xìn
勝利	胜利	shènglì
魅力	魅力	mèilì
首長	首长	shǒuzhǎng
勝利	胜利	shènglì
過年	过年	guònián
毫不	毫不	háobù
組長	组长	zǔzhǎng
專長	专长	zhuāncháng
物品	物品	wùpǐn
哇	哇	wā
後者	后者	hòuzhě
輔助	辅助	fǔzhù
珍貴	珍贵	zhēnguì
景象	景象	jǐngxiàng
選出	选出	xuǎnchū
澎湖	澎湖	pénghú
學員	学员	xuéyuán
監督	监督	jiāndū
加拿大	加拿大	jiānádà
以色列	以色列	yǐsèliè
參賽	参赛	cānsài
混亂	混乱	hǔnluàn
走出	走出	zǒuchū
收到	收到	shōudào
佛	佛	fó
如同	如同	rútóng
初	初	chū
混亂	混乱	hǔnluàn
排	排	pái
歲月	岁月	suìyuè
參賽	参赛	cānsài
屆時	届时	jièshí
這邊	这边	zhèbiān
班	班	bān
塑造	塑造	sùzào
權威	权威	quánwēi
雙重	双重	shuāngchóng
古老	古老	gǔlǎo
廣播	广播	guǎngbō
樂觀	乐观	lèguān
塑造	塑造	sùzào
定期	定期	dìngqí
強大	强大	qiángdà
社會主義	社会主义	shèhuìzhǔyì
事宜	事宜	shìyí
交往	交往	jiāowǎng
時空	时空	shíkōng
露出	露出	lòuchū
請教	请教	qǐngjiào
繁榮	繁荣	fánróng
嬉皮	嬉皮	xīpí
繁榮	繁荣	fánróng
斤	斤	jīn
暨	暨	jì
行情	行情	hángqíng
先導	先导	xiāndǎo
防治	防治	fángzhì
列入	列入	lièrù
依據	依据	yījù
完美	完美	wánměi
同胞	同胞	tóngbāo
原理	原理	yuánlǐ
財富	财富	cáifù
黃	黄	huáng
難免	难免	nánmiǎn
中小企業	中小企业	zhōngxiǎoqìyè
全力	全力	quánlì
影響到	影响到	yǐngxiǎngdào
貴族	贵族	guìzú
祖先	祖先	zǔxiān
待	待	dài
怎麼	怎么	zěnme
流通	流通	liútōng
姊姊	姊姊	jiějiě
純	纯	chún
學會	学会	xuéhuì
聯繫	联系	liánxì
報	报	bào
颱風	台风	táifēng
盤	盘	pán
精緻	精致	jīngzhì
聯考	联考	liánkǎo
隊伍	队伍	duìwǔ
大台北	大台北	dàtáiběi
和尚	和尚	héshàng
聯繫	联系	liánxì
回收	回收	huíshōu
便是	便是	biànshì
後	后	hòu
師範	师范	shīfàn
陷入	陷入	xiànrù
旅	旅	lǔ
高度	高度	gāodù
租	租	zū
副	副	fù
義大利	义大利	yìdàlì
籃球	篮球	lánqiú
生產力	生产力	shēngchǎnlì
犯	犯	fàn
評鑑	评鑑	píngjiàn
搜尋	搜寻	sōuxún
有利	有利	yǒulì
情境	情境	qíngjìng
處處	处处	chùchù
則	则	zé
物價	物价	wùjià
宜	宜	yí
弄	弄	nòng
根	根	gēn
評鑑	评鑑	píngjiàn
趟	趟	tàng
歌曲	歌曲	gēqǔ
燒	烧	shāo
趙	赵	zhào
文物	文物	wénwù
四處	四处	sìchù
心臟	心脏	xīnzàng
難怪	难怪	nánguài
唱歌	唱歌	chànggē
數目	数目	shùmù
不時	不时	bùshí
修訂	修订	xiūdìng
詞彙	词汇	cíhuì
乾脆	干脆	gāncuì
社長	社长	shèzhǎng
修訂	修订	xiūdìng
唱歌	唱歌	chànggē
球場	球场	qiúchǎng
身份	身份	shēnfèn
解釋	解释	jiěshì
計畫	计画	jìhuà
水果	水果	shuǐguǒ
發明	发明	fāmíng
戶外	户外	hùwài
司法	司法	sīfǎ
熱門	热门	rèmén
環保局	环保局	huánbǎojú
解放	解放	jiěfàng
草	草	cǎo
東吳	东吴	dōngwú
幸運	幸运	xìngyùn
解放	解放	jiěfàng
違規	违规	wéiguī
下來	下来	xiàlái
熱心	热心	rèxīn
算	算	suàn
領	领	lǐng
創新	创新	chuàngxīn
電	电	diàn
靈魂	灵魂	línghún
尊嚴	尊严	zūnyán
協商	协商	xiéshāng
網	网	wǎng
軍人	军人	jūnrén
物件	物件	wùjiàn
省府	省府	shěngfǔ
背	背	bèi
書法	书法	shūfǎ
違規	违规	wéiguī
創新	创新	chuàngxīn
運輸	运输	yùnshū
禮拜	礼拜	lǐbài
觀	观	guān
願望	愿望	yuànwàng
臨床	临床	línchuáng
練	练	liàn
麻煩	麻烦	máfán
當成	当成	dāngchéng
皇帝	皇帝	huángdì
男孩	男孩	nánhái
有錢	有钱	yǒuqián
瑞士	瑞士	ruìshì
何況	何况	hékuàng
擴充	扩充	kuòchōng
獎勵	奖励	jiǎnglì
分佈	分佈	fēnbù
競賽	竞赛	jìngsài
對應	对应	duìyìng
嚴肅	严肃	yánsù
脫離	脱离	tuōlí
主委	主委	zhǔwěi
應付	应付	yìngfù
注意到	注意到	zhùyìdào
安裝	安装	ānzhuāng
國王	国王	guówáng
著	着	zhuó
筆	笔	bǐ
發達	发达	fādá
單一	单一	dānyī
安裝	安装	ānzhuāng
歷經	历经	lìjīng
飲料	饮料	yǐnliào
萬一	万一	wànyī
機械	机械	jīxiè
影響力	影响力	yǐngxiǎnglì
不免	不免	bùmiǎn
加速	加速	jiāsù
加州	加州	jiāzhōu
專	专	zhuān
比率	比率	bǐlù
科目	科目	kēmù
致力	致力	zhìlì
完善	完善	wánshàn
成人	成人	chéngrén
吵架	吵架	chǎojià
名額	名额	míngé
完善	完善	wánshàn
吵架	吵架	chǎojià
發	发	fā
換句話說	换句话说	huànjùhuàshuō
產	产	chǎn
不然	不然	bùrán
支付	支付	zhīfù
可行	可行	kěxíng
支付	支付	zhīfù
變化	变化	biànhuà
競選	竞选	jìngxuǎn
關	关	guān
競選	竞选	jìngxuǎn
雙手	双手	shuāngshǒu
有些	有些	yǒuxiē
名	名	míng
表	表	biǎo
社員	社员	shèyuán
產	产	chǎn
反應	反应	fǎnyìng
假	假	jiǎ
樂園	乐园	lèyuán
餓死	饿死	èsǐ
湖	湖	hú
國際化	国际化	guójìhuà
營養	营养	yíngyǎng
轉	转	zhuǎn
不便	不便	búbiàn
反	反	fǎn
山地	山地	shāndì
考驗	考验	kǎoyàn
不變	不变	búbiàn
成	成	chéng
國際化	国际化	guójìhuà
時光	时光	shíguāng
念書	念书	niànshū
多元化	多元化	duōyuánhuà
交通部	交通部	jiāotōngbù
依法	依法	yīfǎ
多元化	多元化	duōyuánhuà
艘	艘	sāo
強化	强化	qiánghuà
煙	烟	yān
勢力	势力	shìlì
敵人	敌人	dírén
儀器	仪器	yíqì
功夫	功夫	gōngfū
不景氣	不景气	bùjǐngqì
離婚	离婚	líhūn
持	持	chí
財政	财政	cáizhèng
離婚	离婚	líhūn
倫理	伦理	lúnlǐ
強盜	强盗	qiángdào
負面	负面	fùmiàn
企業界	企业界	qìyèjiè
紅色	红色	hóngsè
施行	施行	shīxíng
列為	列为	lièwéi
強化	强化	qiánghuà
姓	姓	xìng
關切	关切	guānqiè
眾人	众人	zhòngrén
禮物	礼物	lǐwù
不利	不利	búlì
不佳	不佳	bùjiā
教育廳	教育厅	jiàoyūtīng
家屬	家属	jiāshǔ
咱們	咱们	zánmen
呼吸	呼吸	hūxī
兒女	儿女	érnǔ
款	款	kuǎn
象徵	象征	xiàngzhēng
煮	煮	zhǔ
顯著	显著	xiǎnzhù
大躍進	大跃进	dàyuèjìn
止	止	zhǐ
付	付	fù
演員	演员	yǎnyuán
嬰兒	婴儿	yīngér
典禮	典礼	diǎnlǐ
忍受	忍受	rěnshòu
城鎮	城镇	chéngzhèn
異常	异常	yìcháng
補助	补助	bǔzhù
案子	案子	ànzi
好朋友	好朋友	hǎopéngyǒu
輕易	轻易	qīngyì
碼頭	码头	mǎtóu
計劃	计划	jìhuà
服務業	服务业	fúwùyè
工作站	工作站	gōngzuòzhàn
外表	外表	wàibiǎo
熊	熊	xióng
勢必	势必	shìbì
鬥爭	斗争	dòuzhēng
研擬	研拟	yánnǐ
行列	行列	hángliè
研擬	研拟	yánnǐ
收藏	收藏	shōucáng
法人	法人	fǎrén
收藏	收藏	shōucáng
企圖	企图	qìtú
再次	再次	zàicì
科系	科系	kēxì
贊助	赞助	zànzhù
網球	网球	wǎngqiú
人心	人心	rénxīn
有用	有用	yǒuyòng
聚集	聚集	jùjí
編列	编列	biānliè
證據	证据	zhèngjù
自身	自身	zìshēn
編列	编列	biānliè
寫作	写作	xiězuò
趁	趁	chèn
進度	进度	jìndù
提前	提前	tíqián
氣息	气息	qìxí
工業區	工业区	gōngyèqū
聚集	聚集	jùjí
會談	会谈	huìtán
慾望	慾望	yūwàng
輸	输	shū
優良	优良	yōuliáng
文獻	文献	wénxiàn
籌備	筹备	chóubèi
勸	劝	quàn
追蹤	追踪	zhuīzōng
籌備	筹备	chóubèi
有線	有线	yǒuxiàn
會談	会谈	huìtán
逐步	逐步	zhúbù
安打	安打	āndǎ
每	每	měi
列印	列印	lièyìn
宣導	宣导	xuāndǎo
城堡	城堡	chéngbǎo
追蹤	追踪	zhuīzōng
收穫	收获	shōuhuò
手冊	手册	shǒucè
燈光	灯光	dēngguāng
語文	语文	yǔwén
團	团	tuán
資策會	资策会	zīcèhuì
一連串	一连串	yīliánchuàn
有心	有心	yǒuxīn
雙	双	shuāng
績效	绩效	jīxiào
逼	逼	bī
鏡頭	镜头	jìngtóu
開心	开心	kāixīn
否定	否定	fǒudìng
地主	地主	dìzhǔ
老大	老大	lǎodà
研究生	研究生	yánjiùshēng
氣質	气质	qìzhí
拿出	拿出	náchū
訴求	诉求	sùqiú
開心	开心	kāixīn
稍微	稍微	shāowéi
利率	利率	lìlù
當選	当选	dāngxuǎn
台南	台南	táinán
擬定	拟定	nǐdìng
隔	隔	gé
經建會	经建会	jīngjiànhuì
貼	贴	tiē
忽視	忽视	hūshì
郝柏村	郝柏村	hǎobócūn
查獲	查获	cháhuò
拆除	拆除	chāichú
忽視	忽视	hūshì
式	式	shì
傳來	传来	chuánlái
象徵	象征	xiàngzhēng
樂	乐	lè
罷了	罢了	bàle
演	演	yǎn
出身	出身	chūshēn
心得	心得	xīndé
出身	出身	chūshēn
上學	上学	shàngxué
去世	去世	qùshì
忙碌	忙碌	mánglù
衛生署	卫生署	wèishēngshǔ
記憶體	记忆体	jìyìtǐ
定位	定位	dìngwèi
忙碌	忙碌	mánglù
紀念	纪念	jìniàn
場面	场面	chángmiàn
得意	得意	déyì
寄	寄	jì
基隆	基隆	jīlóng
效應	效应	xiàoyìng
海水	海水	hǎishuǐ
貸款	贷款	dàikuǎn
夫婦	夫妇	fūfù
擬	拟	nǐ
代表	代表	dàibiǎo
舊金山	旧金山	jiùjīnshān
蝴蝶	蝴蝶	húdié
盡量	尽量	jìnliàng
過度	过度	guòdù
乃	乃	nǎi
發起	发起	fāqǐ
角落	角落	jiǎoluò
防	防	fáng
附加	附加	fùjiā
屏東	屏东	píngdōng
國籍	国籍	guójí
章	章	zhāng
義務	义务	yìwù
開口	开口	kāikǒu
移民	移民	yímín
出	出	chū
主張	主张	zhǔzhāng
上漲	上涨	shàngzhǎng
請求	请求	qǐngqiú
測試	测试	cèshì
不到	不到	búdào
恐懼	恐惧	kǒngjù
來得	来得	láide
得知	得知	dézhī
挑戰	挑战	tiǎozhàn
排除	排除	páichú
最為	最为	zuìwéi
排除	排除	páichú
眼淚	眼泪	yǎnlèi
專輯	专辑	zhuānjí
恐懼	恐惧	kǒngjù
教導	教导	jiàodǎo
田	田	tián
僅有	仅有	jǐnyǒu
移植	移植	yízhí
核酸	核酸	hésuān
教導	教导	jiàodǎo
趕緊	赶紧	gǎnjǐn
業績	业绩	yèjī
點	点	diǎn
平靜	平静	píngjìng
口號	口号	kǒuhào
山西	山西	shānxī
出版品	出版品	chūbǎnpǐn
逃避	逃避	táobì
咬	咬	yǎo
平靜	平静	píngjìng
有關	有关	yǒuguān
背	背	bèi
石油	石油	shíyóu
雪	雪	xuě
局長	局长	júzhǎng
展覽	展览	zhǎnlǎn
面貌	面貌	miànmào
現實	现实	xiànshí
秘書長	秘书长	mìshūzhǎng
討厭	讨厌	tǎoyàn
移植	移植	yízhí
插	插	chā
東部	东部	dōngbù
決心	决心	juéxīn
聯邦	联邦	liánbāng
電台	电台	diàntái
講座	讲座	jiǎngzuò
貓	猫	māo
新興	新兴	xīnxīng
演講	演讲	yǎnjiǎng
台電	台电	táidiàn
曰	曰	yuē
選民	选民	xuǎnmín
充份	充份	chōngfèn
俱樂部	俱乐部	jùlèbù
錦標賽	锦标赛	jǐnbiāosài
始	始	shǐ
門	门	mén
英	英	yīng
推	推	tuī
拿到	拿到	nádào
童年	童年	tóngnián
期限	期限	qíxiàn
惡化	恶化	èhuà
證實	证实	zhèngshí
碩士	硕士	shuòshì
編輯	编辑	biānjí
審核	审核	shěnhé
遠	远	yuǎn
分局	分局	fēnjú
申報	申报	shēnbào
與否	与否	yǔfǒu
邁向	迈向	màixiàng
總之	总之	zǒngzhī
職務	职务	zhíwù
延續	延续	yánxù
嚇	吓	xià
費率	费率	fèilù
美國人	美国人	měiguórén
高速	高速	gāosù
商標	商标	shāngbiāo
嫌	嫌	xián
進修	进修	jìnxiū
傳遞	传递	chuándì
場合	场合	chǎnghé
詩人	诗人	shīrén
腰	腰	yāo
傳遞	传递	chuándì
股價	股价	gǔjià
歌聲	歌声	gēshēng
桃園	桃园	táoyuán
溫馨	温馨	wēnxīn
無比	无比	wúbǐ
著重	着重	zhuózhòng
減輕	减轻	jiǎnqīng
提	提	tí
意味	意味	yìwèi
說不定	说不定	shuōbúdìng
公民	公民	gōngmín
中興	中兴	zhōngxīng
移動	移动	yídòng
減輕	减轻	jiǎnqīng
有待	有待	yǒudài
船員	船员	chuányuán
中興	中兴	zhōngxīng
丟	丢	diōu
走路	走路	zǒulù
身材	身材	shēncái
好玩	好玩	hǎowán
師父	师父	shīfù
架	架	jià
服裝	服装	fúzhuāng
枚	枚	méi
陳列	陈列	chénliè
移動	移动	yídòng
前者	前者	qiánzhě
寶貴	宝贵	bǎoguì
興起	兴起	xīngqǐ
遭受	遭受	zāoshòu
聯合	联合	liánhé
興起	兴起	xīngqǐ
摸	摸	mō
下	下	xià
邏輯	逻辑	luójí
奶奶	奶奶	nǎinǎi
價位	价位	jiàwèi
寶貴	宝贵	bǎoguì
牙齒	牙齿	yáchǐ
武力	武力	wǔlì
腫瘤	肿瘤	zhǒngliú
題材	题材	tícái
典型	典型	diǎnxíng
作風	作风	zuòfēng
初步	初步	chūbù
胃	胃	wèi
從未	从未	cóngwèi
旅行社	旅行社	lǔxíngshè
聊天	聊天	liáotiān
執著	执着	zhízhuó
鄉土	乡土	xiāngtǔ
頓	顿	dùn
非法	非法	fēifǎ
統計	统计	tǒngjì
演唱	演唱	yǎnchàng
十足	十足	shízú
介紹	介绍	jièshào
古人	古人	gǔrén
窮	穷	qióng
演唱	演唱	yǎnchàng
細	细	xì
體力	体力	tǐlì
涉嫌	涉嫌	shèxián
同性戀	同性恋	tóngxìngliàn
無聊	无聊	wúliáo
機種	机种	jīzhǒng
土	土	tǔ
邊緣	边缘	biānyuán
平安	平安	píngān
出面	出面	chūmiàn
半導體	半导体	bàndǎotǐ
平安	平安	píngān
工研院	工研院	gōngyányuàn
燈	灯	dēng
地板	地板	dìbǎn
舒適	舒适	shūshì
著作權	著作权	zhùzuòquán
細節	细节	xìjié
侵害	侵害	qīnhài
好看	好看	hǎokàn
立	立	lì
器材	器材	qìcái
地形	地形	dìxíng
歡樂	欢乐	huānlè
說出	说出	shuōchū
陽明	阳明	yángmíng
正義	正义	zhèngyì
分散	分散	fēnsàn
回憶	回忆	huíyì
測驗	测验	cèyàn
歡樂	欢乐	huānlè
海報	海报	hǎibào
高階	高阶	gāojiē
副教授	副教授	fùjiàoshòu
信念	信念	xìnniàn
花費	花费	huāfèi
自在	自在	zìzài
刺激	刺激	cìjī
技能	技能	jìnéng
私立	私立	sīlì
回憶	回忆	huíyì
維修	维修	wéixiū
壓迫	压迫	yāpò
戲劇	戏剧	xìjù
公佈	公佈	gōngbù
廿	廿	niàn
公佈	公佈	gōngbù
升學	升学	shēngxué
鬧	闹	nào
上下	上下	shàngxià
說道	说道	shuōdào
升學	升学	shēngxué
自有	自有	zìyǒu
維修	维修	wéixiū
傳	传	chuán
走上	走上	zǒushàng
沒辦法	没办法	méibànfǎ
爬	爬	pá
哪些	哪些	nǎxiē
清潔	清洁	qīngjié
探索	探索	tànsuǒ
滋味	滋味	zīwèi
血管	血管	xiěguǎn
解	解	jiě
籌備處	筹备处	chóubèichù
團結	团结	tuánjié
開拓	开拓	kāituò
喜悅	喜悦	xǐyuè
開拓	开拓	kāituò
龍	龙	lóng
團結	团结	tuánjié
價錢	价钱	jiàqián
盡速	尽速	jǐnsù
領導人	领导人	lǐngdǎorén
慢性	慢性	mànxìng
台商	台商	táishāng
不致	不致	búzhì
打工	打工	dǎgōng
創	创	chuàng
限	限	xiàn
公營	公营	gōngyíng
根本	根本	gēnběn
行	行	xíng
珍惜	珍惜	zhēnxí
容量	容量	róngliàng
園區	园区	yuánqū
抬頭	抬头	táitóu
空地	空地	kòngdì
所長	所长	suǒzhǎng
喜悅	喜悦	xǐyuè
停車	停车	tíngchē
馬來西亞	马来西亚	mǎláixīyǎ
停車	停车	tíngchē
國防	国防	guófáng
帶有	带有	dàiyǒu
淘汰	淘汰	táotài
抬頭	抬头	táitóu
注音	注音	zhùyīn
實用	实用	shíyòng
夢想	梦想	mèngxiǎng
奮鬥	奋斗	fèndòu
頗為	颇为	pǒwéi
構造	构造	gòuzào
熱情	热情	rèqíng
必定	必定	bìdìng
水平	水平	shuǐpíng
比賽	比赛	bǐsài
在乎	在乎	zàihū
協議	协议	xiéyì
編制	编制	biānzhì
平面	平面	píngmiàn
剛好	刚好	gānghǎo
彭	彭	péng
放心	放心	fàngxīn
含有	含有	hányǒu
停留	停留	tíngliú
停車場	停车场	tíngchēchǎng
停留	停留	tíngliú
售價	售价	shòujià
解除	解除	jiěchú
照	照	zhào
無形	无形	wúxíng
違法	违法	wéifǎ
解除	解除	jiěchú
北方	北方	běifāng
感覺到	感觉到	gǎnjuédào
打擊	打击	dǎjí
幢	幢	chuáng
模糊	模糊	móhú
對抗	对抗	duìkàng
駐	驻	zhù
會場	会场	huìchǎng
贏	赢	yíng
負	负	fù
景	景	jǐng
回饋	回馈	huíkuì
歧視	歧视	qíshì
昆蟲	昆虫	kūnchóng
原料	原料	yuánliào
歧視	歧视	qíshì
被迫	被迫	bèipò
雲	云	yún
郵件	邮件	yóujiàn
守	守	shǒu
下來	下来	xiàlái
槍	枪	qiāng
劍	剑	jiàn
課外	课外	kèwài
寧靜	宁静	níngjìng
論	论	lùn
編	编	biān
分組	分组	fēnzǔ
預測	预测	yūcè
一同	一同	yītóng
密集	密集	mìjí
代替	代替	dàitì
凡是	凡是	fánshì
開辦	开办	kāibàn
意志	意志	yìzhì
創造力	创造力	chuàngzàolì
開辦	开办	kāibàn
猜	猜	cāi
晚間	晚间	wǎnjiān
密集	密集	mìjí
掙扎	挣扎	zhēngzhá
瓶	瓶	píng
美金	美金	měijīn
挖	挖	wā
投手	投手	tóushǒu
歸	归	guī
發明	发明	fāmíng
分組	分组	fēnzǔ
考察	考察	kǎochá
驚訝	惊讶	jīngyà
聽眾	听众	tīngzhòng
驚訝	惊讶	jīngyà
不可以	不可以	bùkěyǐ
考察	考察	kǎochá
外國人	外国人	wàiguórén
工資	工资	gōngzī
平台	平台	píngtái
模樣	模样	móyàng
說到	说到	shuōdào
遙遠	遥远	yáoyuǎn
豪華	豪华	háohuá
交	交	jiāo
心力	心力	xīnlì
決賽	决赛	juésài
剩	剩	shèng
安慰	安慰	ānwèi
取向	取向	qǔxiàng
兩性	两性	liǎngxìng
度過	度过	dùguò
哇	哇	wā
哈哈	哈哈	hāhā
笑容	笑容	xiàoróng
專用	专用	zhuānyòng
把握	把握	bǎwò
擴張	扩张	kuòzhāng
載	载	zài
傷心	伤心	shāngxīn
盡	尽	jìn
疑問	疑问	yíwèn
遵守	遵守	zūnshǒu
介面	介面	jièmiàn
共和國	共和国	gònghéguó
下雨	下雨	xiàyǔ
感受	感受	gǎnshòu
擴張	扩张	kuòzhāng
示範	示范	shìfàn
大戰	大战	dàzhàn
定位	定位	dìngwèi
亮	亮	liàng
示範	示范	shìfàn
間接	间接	jiànjiē
偵辦	侦办	zhēnbàn
特有	特有	tèyǒu
消除	消除	xiāochú
區分	区分	qūfēn
評價	评价	píngjià
發掘	发掘	fājué
外銷	外销	wàixiāo
還可以	还可以	háikěyǐ
外銷	外销	wàixiāo
不宜	不宜	bùyí
不如	不如	bùrú
隨即	随即	suíjí
隨意	随意	suíyì
踴躍	踊跃	yǒngyuè
能量	能量	néngliàng
接下來	接下来	jiēxiàlái
接到	接到	jiēdào
治安	治安	zhìān
指示	指示	zhǐshì
同步	同步	tóngbù
茶葉	茶叶	cháyè
騙	骗	piàn
富裕	富裕	fùyū
優美	优美	yōuměi
壓抑	压抑	yāyì
優美	优美	yōuměi
預料	预料	yūliào
劇團	剧团	jùtuán
跨	跨	kuà
壓抑	压抑	yāyì
開闢	开闢	kāipì
沒關係	没关系	méiguānxì
機能	机能	jīnéng
名叫	名叫	míngjiào
開闢	开闢	kāipì
念頭	念头	niàntóu
富裕	富裕	fùyū
改良	改良	gǎiliáng
利	利	lì
核准	核准	hézhǔn
接收	接收	jiēshōu
核准	核准	hézhǔn
接收	接收	jiēshōu
相似	相似	xiāngsì
聞	闻	wén
貧窮	贫穷	pínqióng
動物園	动物园	dòngwùyuán
接近	接近	jiējìn
餓	饿	è
瞧	瞧	qiáo
諸如	诸如	zhūrú
分公司	分公司	fēngōngsī
總統府	总统府	zǒngtǒngfǔ
同情	同情	tóngqíng
貧窮	贫穷	pínqióng
鎮公所	镇公所	zhèngōngsuǒ
沙漠	沙漠	shāmò
放下	放下	fàngxià
音色	音色	yīnsè
相較	相较	xiāngjiào
拖	拖	tuō
好友	好友	hǎoyǒu
吸	吸	xī
同情	同情	tóngqíng
走勢	走势	zǒushì
西洋	西洋	xīyáng
書目	书目	shūmù
資本主義	资本主义	zīběnzhǔyì
增	增	zēng
歷程	历程	lìchéng
濃厚	浓厚	nónghòu
失業	失业	shīyè
視野	视野	shìyě
永恆	永恒	yǒnghéng
同志	同志	tóngzhì
中年	中年	zhōngnián
極了	极了	jíle5
清大	清大	qīngdà
記錄	记录	jìlù
風味	风味	fēngwèi
合格	合格	hégé
身子	身子	shēnzi5
百姓	百姓	bǎixìng
太空	太空	tàikōng
大力	大力	dàlì
勉強	勉强	miǎnqiǎng
外來	外来	wàilái
失業	失业	shīyè
生病	生病	shēngbìng
鋼琴	钢琴	gāngqín
號碼	号码	hàomǎ
另	另	lìng
口味	口味	kǒuwèi
天生	天生	tiānshēng
回頭	回头	huítóu
心想	心想	xīnxiǎng
包裝	包装	bāozhuāng
對待	对待	duìdài
遊	遊	yóu
感激	感激	gǎnjī
單	单	dān
師	师	shī
學科	学科	xuékē
感激	感激	gǎnjī
弟子	弟子	dìzǐ
招生	招生	zhāoshēng
好人	好人	hǎorén
倒	倒	dào
捕	捕	bǔ
招生	招生	zhāoshēng
針	针	zhēn
溫度	温度	wēndù
長久	长久	chángjiǔ
運動	运动	yùndòng
焦慮	焦虑	jiāolù
支出	支出	zhīchū
焦慮	焦虑	jiāolù
上班族	上班族	shàngbānzú
一律	一律	yīlù
轉移	转移	zhuǎnyí
關注	关注	guānzhù
響	响	xiǎng
黨部	党部	dǎngbù
轉移	转移	zhuǎnyí
硬	硬	yìng
洗澡	洗澡	xǐzǎo
關注	关注	guānzhù
老鼠	老鼠	lǎoshǔ
昂貴	昂贵	ángguì
決議	决议	juéyì
動員	动员	dòngyuán
在場	在场	zàichǎng
兼顧	兼顾	jiāngù
相比	相比	xiāngbǐ
後果	后果	hòuguǒ
混合	混合	hùnhé
動員	动员	dòngyuán
陰影	阴影	yīnyǐng
海峽	海峡	hǎixiá
幻想	幻想	huànxiǎng
劇場	剧场	jùchǎng
衡量	衡量	héngliáng
頻率	频率	pínlù
衡量	衡量	héngliáng
親切	亲切	qīnqiè
藍	蓝	lán
大膽	大胆	dàdǎn
議會	议会	yìhuì
語意	语意	yǔyì
主因	主因	zhǔyīn
團員	团员	tuányuán
親切	亲切	qīnqiè
世	世	shì
激動	激动	jīdòng
村民	村民	cūnmín
投	投	tóu
交	交	jiāo
官	官	guān
次數	次数	cìshù
恐怖	恐怖	kǒngbù
弱	弱	ruò
屋頂	屋顶	wūdǐng
迷宮	迷宫	mígōng
批判	批判	pīpàn
民生	民生	mínshēng
規畫	规画	guīhuà
唯	唯	wéi
感	感	gǎn
賞	赏	shǎng
綠色	绿色	lùsè
遺憾	遗憾	yíhàn
靈活	灵活	línghuó
內閣	内阁	nèigé
山區	山区	shānqū
做成	做成	zuòchéng
觀光客	观光客	guānguāngkè
出	出	chū
老先生	老先生	lǎoxiānshēng
靈活	灵活	línghuó
研習	研习	yánxí
周邊	周边	zhōubiān
希臘	希腊	xīlà
姓名	姓名	xìngmíng
抓住	抓住	zhuāzhù
合適	合适	héshì
老百姓	老百姓	lǎobǎixìng
再見	再见	zàijiàn
指責	指责	zhǐzé
限於	限于	xiànyū
研習	研习	yánxí
車禍	车祸	chēhuò
曝光	曝光	pùguāng
優惠	优惠	yōuhuì
無意	无意	wúyì
優惠	优惠	yōuhuì
漲	涨	zhàng
實務	实务	shíwù
潛能	潜能	qiánnéng
聞名	闻名	wénmíng
擠	挤	jǐ
說完	说完	shuōwán
歹徒	歹徒	dǎitú
職位	职位	zhíwèi
排列	排列	páiliè
曝光	曝光	pùguāng
師資	师资	shīzī
菲律賓	菲律宾	fēilùbīn
媽祖	妈祖	māzǔ
名義	名义	míngyì
客氣	客气	kèqì
服飾	服饰	fúshì
哎	哎	āi
恐嚇	恐吓	kǒnghè
專心	专心	zhuānxīn
排列	排列	páiliè
執政黨	执政党	zhízhèngdǎng
完畢	完毕	wánbì
氣	气	qì
卡通	卡通	kǎtōng
犀牛	犀牛	xīnióu
遍	遍	biàn
誕生	诞生	dànshēng
出售	出售	chūshòu
用品	用品	yòngpǐn
欠缺	欠缺	qiànquē
自由化	自由化	zìyóuhuà
住戶	住户	zhùhù
台北縣	台北县	táiběixiàn
擺脫	摆脱	bǎituō
供應商	供应商	gōngyìngshāng
講究	讲究	jiǎngjiù
自由化	自由化	zìyóuhuà
命令	命令	mìnglìng
伯伯	伯伯	bóbó
東亞	东亚	dōngyǎ
若要	若要	ruòyào
笑話	笑话	xiàohuà
胸	胸	xiōng
被害人	被害人	bèihàirén
啟用	启用	qǐyòng
拿來	拿来	nálái
帶回	带回	dàihuí
啟用	启用	qǐyòng
必需	必需	bìxū
配置	配置	pèizhì
輔仁	辅仁	fǔrén
提早	提早	tízǎo
溫柔	温柔	wēnróu
談判	谈判	tánpàn
頭痛	头痛	tóutòng
上級	上级	shàngjí
一度	一度	yīdù
配置	配置	pèizhì
諸多	诸多	zhūduō
電動	电动	diàndòng
助益	助益	zhùyì
公職	公职	gōngzhí
冷靜	冷静	lěngjìng
鬼	鬼	guǐ
冷靜	冷静	lěngjìng
合唱團	合唱团	héchàngtuán
求學	求学	qiúxué
重量	重量	zhòngliàng
長榮	长荣	chángróng
陌生	陌生	mòshēng
通路	通路	tōnglù
國父	国父	guófù
目錄	目录	mùlù
敗	败	bài
考古	考古	kǎogǔ
高等	高等	gāoděng
電訊	电讯	diànxùn
遭遇	遭遇	zāoyū
趕	赶	gǎn
台灣省	台湾省	táiwānshěng
體質	体质	tǐzhí
考慮到	考虑到	kǎolùdào
途中	途中	túzhōng
考古	考古	kǎogǔ
決議	决议	juéyì
記載	记载	jìzài
施政	施政	shīzhèng
角	角	jiǎo
先行	先行	xiānxíng
美感	美感	měigǎn
施政	施政	shīzhèng
挑	挑	tiāo
姿態	姿态	zītài
青春	青春	qīngchūn
攤販	摊贩	tānfàn
日漸	日渐	rìjiàn
圖片	图片	túpiàn
衛生局	卫生局	wèishēngjú
彌補	弥补	míbǔ
獨自	独自	dúzì
夥伴	夥伴	huǒbàn
正	正	zhèng
回歸	回归	huíguī
分開	分开	fēnkāi
難題	难题	nántí
羅馬	罗马	luómǎ
明亮	明亮	míngliàng
談話	谈话	tánhuà
藏	藏	cáng
個體	个体	gètǐ
順序	顺序	shùnxù
助教	助教	zhùjiào
前述	前述	qiánshù
帝國	帝国	dìguó
特地	特地	tèdì
執照	执照	zhízhào
名為	名为	míngwéi
部會	部会	bùhuì
新聞局	新闻局	xīnwénjú
新生	新生	xīnshēng
萬物	万物	wànwù
悲劇	悲剧	bēijù
早日	早日	zǎorì
離去	离去	líqù
人選	人选	rénxuǎn
電視台	电视台	diànshìtái
親戚	亲戚	qīnqī
營業額	营业额	yíngyèé
彰化	彰化	zhānghuà
質	质	zhí
一點兒	一点儿	yīdiǎnēr
水源	水源	shuǐyuán
主流	主流	zhǔliú
藝術品	艺术品	yìshùpǐn
離去	离去	líqù
薪水	薪水	xīnshuǐ
觀測	观测	guāncè
愛滋病	爱滋病	àizībìng
簡介	简介	jiǎnjiè
觀測	观测	guāncè
光線	光线	guāngxiàn
範疇	范畴	fànchóu
色情	色情	sèqíng
幅度	幅度	fúdù
夜間部	夜间部	yèjiānbù
佛陀	佛陀	fótuó
南方	南方	nánfāng
首度	首度	shǒudù
胖	胖	pàng
相當於	相当于	xiāngdāngyū
狼	狼	láng
秘密	秘密	mìmì
商場	商场	shāngchǎng
海軍	海军	hǎijūn
尋	寻	xún
鄉村	乡村	xiāngcūn
花錢	花钱	huāqián
甫	甫	fǔ
煩惱	烦恼	fánnǎo
逮捕	逮捕	dǎibǔ
開設	开设	kāishè
廁所	厕所	cèsuǒ
繁殖	繁殖	fánzhí
融合	融合	rónghé
漁船	渔船	yūchuán
繁殖	繁殖	fánzhí
劉	刘	liú
下令	下令	xiàlìng
生動	生动	shēngdòng
融合	融合	rónghé
老太太	老太太	lǎotàitài
成長率	成长率	chéngzhǎnglù
老是	老是	lǎoshì
周	周	zhōu
開設	开设	kāishè
抗	抗	kàng
看好	看好	kànhǎo
阿拉伯	阿拉伯	ālābó
紀念	纪念	jìniàn
長達	长达	chángdá
所屬	所属	suǒshǔ
馬祖	马祖	mǎzǔ
真相	真相	zhēnxiàng
妥善	妥善	tuǒshàn
編目	编目	biānmù
開創	开创	kāichuàng
模特兒	模特儿	mótèēr
圖騰	图腾	túténg
辦公	办公	bàngōng
遲	迟	chí
編目	编目	biānmù
線路	线路	xiànlù
刊物	刊物	kānwù
而後	而后	érhòu
人潮	人潮	réncháo
聲明	声明	shēngmíng
動手	动手	dòngshǒu
購	购	gòu
蛋	蛋	dàn
薪資	薪资	xīnzī
好吃	好吃	hǎochī
開創	开创	kāichuàng
定居	定居	dìngjū
被告	被告	bèigào
安靜	安静	ānjìng
災難	灾难	zāinàn
交談	交谈	jiāotán
定居	定居	dìngjū
同業	同业	tóngyè
住宿	住宿	zhùsù
缺少	缺少	quēshǎo
何必	何必	hébì
住宿	住宿	zhùsù
交談	交谈	jiāotán
便當	便当	biàndāng
抽煙	抽烟	chōuyān
如同	如同	rútóng
領隊	领队	lǐngduì
進出	进出	jìnchū
減	减	jiǎn
新娘	新娘	xīnniáng
圖案	图案	túàn
腳踏車	脚踏车	jiǎotàchē
頻繁	频繁	pínfán
落	落	luò
進出	进出	jìnchū
電梯	电梯	diàntī
學分	学分	xuéfēn
題	题	tí
實習	实习	shíxí
支撐	支撑	zhīchēng
母語	母语	mǔyǔ
包	包	bāo
補習班	补习班	bǔxíbān
實習	实习	shíxí
吃完	吃完	chīwán
鄉下	乡下	xiāngxià
交大	交大	jiāodà
放寬	放宽	fàngkuān
既有	既有	jìyǒu
研討	研讨	yántǎo
抽象	抽象	chōuxiàng
研討	研讨	yántǎo
高山	高山	gāoshān
假設	假设	jiǎshè
販賣	贩卖	fànmài
票	票	piào
販賣	贩卖	fànmài
國土	国土	guótǔ
票	票	piào
無線電	无线电	wúxiàndiàn
各式各樣	各式各样	gèshìgèyàng
前言	前言	qiányán
工商	工商	gōngshāng
激發	激发	jīfā
學歷	学历	xuélì
趣味	趣味	qùwèi
天堂	天堂	tiāntáng
提倡	提倡	tíchàng
總裁	总裁	zǒngcái
分數	分数	fēnshù
上山	上山	shàngshān
失	失	shī
肌膚	肌肤	jīfū
兵	兵	bīng
提倡	提倡	tíchàng
啤酒	啤酒	píjiǔ
公開賽	公开赛	gōngkāisài
信用	信用	xìnyòng
測	测	cè
提案	提案	tíàn
吋	吋	cùn
批評	批评	pīpíng
尾巴	尾巴	yǐba5
風潮	风潮	fēngcháo
星	星	xīng
迷信	迷信	míxìn
吐	吐	tǔ
鐵	铁	tiě
重心	重心	zhòngxīn
迷信	迷信	míxìn
海拔	海拔	hǎibá
眾生	众生	zhòngshēng
明	明	míng
徵收	征收	zhēngshōu
變更	变更	biàngēng
尊敬	尊敬	zūnjìng
徵收	征收	zhēngshōu
線條	线条	xiàntiáo
瘋狂	疯狂	fēngkuáng
總共	总共	zǒnggòng
尊敬	尊敬	zūnjìng
人家	人家	rénjiā
元素	元素	yuánsù
永	永	yǒng
共產黨	共产党	gòngchǎndǎng
共產主義	共产主义	gòngchǎnzhǔyì
加速	加速	jiāsù
鏡子	镜子	jìngzi5
絲毫	丝毫	sīháo
職棒	职棒	zhíbàng
巡迴	巡迴	xúnhuí
自治	自治	zìzhì
終場	终场	zhōngcháng
同	同	tóng
技藝	技艺	jìyì
西班牙	西班牙	xībānyá
合乎	合乎	héhū
巡迴	巡迴	xúnhuí
描寫	描写	miáoxiě
阻止	阻止	zǔzhǐ
假期	假期	jiàqí
偶像	偶像	ǒuxiàng
描寫	描写	miáoxiě
特點	特点	tèdiǎn
高血壓	高血压	gāoxiěyā
返回	返回	fǎnhuí
阻止	阻止	zǔzhǐ
懷念	怀念	huáiniàn
乏	乏	fá
錯過	错过	cuòguò
器官	器官	qìguān
漁民	渔民	yūmín
頭腦	头脑	tóunǎo
樹林	树林	shùlín
分裂	分裂	fēnliè
公告	公告	gōnggào
市面	市面	shìmiàn
羨慕	羨慕	xiànmù
驕傲	骄傲	jiāoào
懷念	怀念	huáiniàn
驕傲	骄傲	jiāoào
住宅區	住宅区	zhùzháiqū
地圖	地图	dìtú
麻煩	麻烦	máfán
長度	长度	chángdù
離	离	lí
相機	相机	xiàngjī
朵	朵	duǒ
產量	产量	chǎnliàng
高層	高层	gāocéng
運算	运算	yùnsuàn
執政	执政	zhízhèng
海岸	海岸	hǎiàn
假	假	jiǎ
運算	运算	yùnsuàn
誠實	诚实	chéngshí
羨慕	羨慕	xiànmù
執政	执政	zhízhèng
隔間	隔间	géjiān
唸書	唸书	niànshū
院校	院校	yuànxiào
除此之外	除此之外	chúcǐzhīwài
棒球	棒球	bàngqiú
圈	圈	quān
壓	压	yā
格外	格外	géwài
寫信	写信	xiěxìn
對策	对策	duìcè
及時	及时	jíshí
種族	种族	zhǒngzú
分工	分工	fēngōng
拜訪	拜访	bàifǎng
前提	前提	qiántí
寫信	写信	xiěxìn
形狀	形状	xíngzhuàng
拜訪	拜访	bàifǎng
居	居	jū
延長	延长	yáncháng
向來	向来	xiànglái
老婆	老婆	lǎopó
弄得	弄得	nòngde5
服食	服食	fúshí
拿起	拿起	náqǐ
指揮	指挥	zhǐhuī
宣傳	宣传	xuānchuán
指揮	指挥	zhǐhuī
要點	要点	yàodiǎn
首都	首都	shǒudū
延長	延长	yáncháng
引用	引用	yǐnyòng
接納	接纳	jiēnà
條文	条文	tiáowén
神秘	神秘	shénmì
專線	专线	zhuānxiàn
移轉	移转	yízhuǎn
詞類	词类	cílèi
憤怒	愤怒	fènnù
審議	审议	shěnyì
學到	学到	xuédào
斷	断	duàn
潰瘍	溃疡	kuìyáng
移轉	移转	yízhuǎn
憤怒	愤怒	fènnù
考	考	kǎo
情景	情景	qíngjǐng
協定	协定	xiédìng
投機	投机	tóujī
姿勢	姿势	zīshì
阿姨	阿姨	àyí
幽默	幽默	yōumò
流傳	流传	liúchuán
幽默	幽默	yōumò
持	持	chí
流傳	流传	liúchuán
接納	接纳	jiēnà
晉級	晋级	jìnjí
耐心	耐心	nàixīn
化解	化解	huàjiě
軌道	轨道	guǐdào
這樣	这样	zhèyàng
記號	记号	jìhào
格局	格局	géjú
強勢	强势	qiángshì
勞資	劳资	láozī
試圖	试图	shìtú
學術界	学术界	xuéshùjiè
且	且	qiě
稱	称	chēng
前進	前进	qiánjìn
未曾	未曾	wèicéng
實	实	shí
法官	法官	fǎguān
炒	炒	chǎo
干擾	干扰	gānrǎo
任	任	rèn
每當	每当	měidāng
怪	怪	guài
好不容易	好不容易	hǎobúróngyì
行動	行动	xíngdòng
拜	拜	bài
勇敢	勇敢	yǒnggǎn
宣稱	宣称	xuānchēng
前進	前进	qiánjìn
指揮	指挥	zhǐhuī
迎接	迎接	yíngjiē
回合	回合	huíhé
攜帶	携带	xīdài
平常	平常	píngcháng
華盛頓	华盛顿	huáshèngdùn
圓滿	圆满	yuánmǎn
港	港	gǎng
榮譽	荣誉	róngyū
確認	确认	quèrèn
大廈	大厦	dàxià
工作室	工作室	gōngzuòshì
平原	平原	píngyuán
聯招	联招	liánzhāo
傳達	传达	chuándá
寶寶	宝宝	bǎobǎo
傳達	传达	chuándá
舉例	举例	jǔlì
故鄉	故乡	gùxiāng
黃色	黄色	huángsè
光復	光复	guāngfù
圓滿	圆满	yuánmǎn
音響	音响	yīnxiǎng
挺	挺	tǐng
翅膀	翅膀	chìbǎng
郭	郭	guō
國宅	国宅	guózhái
記	记	jì
情慾	情慾	qíngyū
偷	偷	tōu
跳舞	跳舞	tiàowǔ
猶	犹	yóu
莊子	庄子	zhuāngzǐ
縮短	缩短	suōduǎn
學業	学业	xuéyè
緊	紧	jǐn
手指	手指	shǒuzhǐ
不料	不料	búliào
矚目	瞩目	zhǔmù
黨營	党营	dǎngyíng
優異	优异	yōuyì
縮短	缩短	suōduǎn
集合	集合	jíhé
護照	护照	hùzhào
承受	承受	chéngshòu
地帶	地带	dìdài
訂單	订单	dìngdān
優異	优异	yōuyì
拓展	拓展	tuòzhǎn
查	查	chá
娶	娶	qǔ
偷偷	偷偷	tōutōu
接獲	接获	jiēhuò
發給	发给	fāgěi
強迫	强迫	qiángpò
如此一來	如此一来	rúcǐyīlái
言	言	yán
天然	天然	tiānrán
暗	暗	àn
愛好	爱好	àihào
帽子	帽子	màozi5
凝聚	凝聚	níngjù
彰化縣	彰化县	zhānghuàxiàn
樹木	树木	shùmù
乙	乙	yǐ
太過	太过	tàiguò
聽見	听见	tīngjiàn
藉以	藉以	jièyǐ
繳	缴	jiǎo
愛好	爱好	àihào
簡化	简化	jiǎnhuà
富	富	fù
簡化	简化	jiǎnhuà
防範	防范	fángfàn
論元	论元	lùnyuán
週期	週期	zhōuqí
地下	地下	dìxià
肩	肩	jiān
男孩子	男孩子	nánháizi5
周遭	周遭	zhōuzāo
悄悄	悄悄	qiāoqiāo
南港	南港	nángǎng
返	返	fǎn
淡江	淡江	dànjiāng
陶瓷	陶瓷	táocí
答覆	答复	dáfù
素質	素质	sùzhí
恨	恨	hèn
作戰	作战	zuòzhàn
堅定	坚定	jiāndìng
增強	增强	zēngqiáng
耳朵	耳朵	ěrduǒ
對立	对立	duìlì
綜合	综合	zònghé
歡喜	欢喜	huānxǐ
模仿	模仿	mófǎng
默默	默默	mòmò
申訴	申诉	shēnsù
歡喜	欢喜	huānxǐ
增強	增强	zēngqiáng
左手	左手	zuǒshǒu
申訴	申诉	shēnsù
入侵	入侵	rùqīn
世人	世人	shìrén
入侵	入侵	rùqīn
友人	友人	yǒurén
文教	文教	wénjiào
麵包	面包	miànbāo
轉	转	zhuǎn
課業	课业	kèyè
團	团	tuán
天文	天文	tiānwén
彩券	彩券	cǎijuàn
優先	优先	yōuxiān
對立	对立	duìlì
材質	材质	cáizhí
埃及	埃及	āijí
看待	看待	kàndài
連結	连结	liánjié
貨物	货物	huòwù
米	米	mǐ
做生意	做生意	zuòshēngyì
連結	连结	liánjié
深度	深度	shēndù
試用	试用	shìyòng
模仿	模仿	mófǎng
釣魚台	钓鱼台	diàoyūtái
試用	试用	shìyòng
起伏	起伏	qǐfú
等級	等级	děngjí
開學	开学	kāixué
椅子	椅子	yǐzi5
排斥	排斥	páichì
起伏	起伏	qǐfú
排斥	排斥	páichì
痕跡	痕迹	hénjī
總會	总会	zǒnghuì
影子	影子	yǐngzi5
製造業	制造业	zhìzàoyè
應當	应当	yīngdāng
調節	调节	tiáojié
總理	总理	zǒnglǐ
戰場	战场	zhàncháng
無窮	无穷	wúqióng
整齊	整齐	zhěngqí
彈	弹	tán
公文	公文	gōngwén
牛奶	牛奶	nióunǎi
毛病	毛病	máobìng
出土	出土	chūtǔ
公正	公正	gōngzhèng
轉型	转型	zhuǎnxíng
圓	圆	yuán
轉型	转型	zhuǎnxíng
望遠鏡	望远镜	wàngyuǎnjìng
類別	类别	lèibié
承擔	承担	chéngdān
虛擬	虚拟	xūnǐ
經濟	经济	jīngjì
老兵	老兵	lǎobīng
江	江	jiāng
流	流	liú
完全	完全	wánquán
研究室	研究室	yánjiùshì
客廳	客厅	kètīng
捕捉	捕捉	bǔzhuō
做人	做人	zuòrén
承辦	承办	chéngbàn
粒子	粒子	lìzǐ
承擔	承担	chéngdān
消極	消极	xiāojí
排	排	pái
得分	得分	défēn
站起來	站起来	zhànqǐlái
從中	从中	cóngzhōng
郝	郝	hǎo
承辦	承办	chéngbàn
註冊	注册	zhùcè
壞人	坏人	huàirén
問道	问道	wèndào
捉	捉	zhuō
退出	退出	tuìchū
開玩笑	开玩笑	kāiwánxiào
註冊	注册	zhùcè
搭乘	搭乘	dāchéng
軟	软	ruǎn
無關	无关	wúguān
嘿	嘿	hēi
罹患	罹患	líhuàn
鼻子	鼻子	bízi
擊出	击出	jíchū
大象	大象	dàxiàng
公立	公立	gōnglì
中部	中部	zhōngbù
退出	退出	tuìchū
生命力	生命力	shēngmìnglì
任意	任意	rènyì
敘述	叙述	xùshù
沙灘	沙滩	shātān
多元	多元	duōyuán
老人家	老人家	lǎorénjiā
深處	深处	shēnchù
吵	吵	chǎo
次	次	cì
企業家	企业家	qìyèjiā
時段	时段	shíduàn
放大	放大	fàngdà
派	派	pài
宣告	宣告	xuāngào
差不多	差不多	chābùduō
海域	海域	hǎiyū
烤	烤	kǎo
奇蹟	奇蹟	qíjī
播放	播放	bòfàng
操場	操场	cāochǎng
播放	播放	bòfàng
傷	伤	shāng
節奏	节奏	jiézòu
匯率	汇率	huìlù
提起	提起	tíqǐ
廢水	废水	fèishuǐ
遇	遇	yū
環	环	huán
螞蟻	蚂蚁	mǎyǐ
精力	精力	jīnglì
上任	上任	shàngrèn
全面	全面	quánmiàn
上台	上台	shàngtái
水質	水质	shuǐzhí
陷阱	陷阱	xiànjǐng
變數	变数	biànshù
規畫	规画	guīhuà
糧	粮	liáng
侵略	侵略	qīnluè
西部	西部	xībù
好手	好手	hǎoshǒu
告知	告知	gàozhī
退	退	tuì
交易所	交易所	jiāoyìsuǒ
乾	干	gān
留學生	留学生	liúxuéshēng
修飾語	修饰语	xiūshìyǔ
容納	容纳	róngnà
很少	很少	hěnshǎo
挖掘	挖掘	wājué
侵略	侵略	qīnluè
近	近	jìn
連接詞	连接词	liánjiēcí
從不	从不	cóngbù
淡水	淡水	dànshuǐ
清	清	qīng
挖掘	挖掘	wājué
孟子	孟子	mèngzi5
穩	稳	wěn
戰後	战后	zhànhòu
福	福	fú
鴨	鸭	yā
營造	营造	yíngzào
機制	机制	jīzhì
機率	机率	jīlù
賦予	赋予	fùyǔ
職員	职员	zhíyuán
現任	现任	xiànrèn
錄音帶	录音带	lùyīndài
外籍	外籍	wàijí
薄	薄	bó
時時	时时	shíshí
事務所	事务所	shìwùsuǒ
扭曲	扭曲	niǒuqū
叔叔	叔叔	shúshú
扭曲	扭曲	niǒuqū
延伸	延伸	yánshēn
哎呀	哎呀	āiyā
流動	流动	liúdòng
原諒	原谅	yuánliàng
哩	哩	li5
氣勢	气势	qìshì
畢業生	毕业生	bìyèshēng
流動	流动	liúdòng
宗旨	宗旨	zōngzhǐ
關愛	关爱	guānài
遺傳	遗传	yíchuán
包袱	包袱	bāofú
壟斷	垄断	lǒngduàn
講到	讲到	jiǎngdào
聯賽	联赛	liánsài
辯論	辩论	biànlùn
關愛	关爱	guānài
瘦	瘦	shòu
遺傳	遗传	yíchuán
辯論	辩论	biànlùn
指令	指令	zhǐlìng
皮	皮	pí
圖形	图形	túxíng
善用	善用	shànyòng
地步	地步	dìbù
怪	怪	guài
威脅	威胁	wēixié
要不然	要不然	yàobùrán
後悔	后悔	hòuhuǐ
金牌	金牌	jīnpái
毒	毒	dú
清晰	清晰	qīngxī
草原	草原	cǎoyuán
立體	立体	lìtǐ
幼兒	幼儿	yòuér
潛水	潜水	qiánshuǐ
矮	矮	ǎi
據點	据点	jùdiǎn
賠償	赔偿	péicháng
碗	碗	wǎn
精采	精采	jīngcǎi
潛水	潜水	qiánshuǐ
頻頻	频频	pínpín
對話	对话	duìhuà
獲利	获利	huòlì
隱藏	隐藏	yǐncáng
精采	精采	jīngcǎi
召集人	召集人	zhàojírén
加工	加工	jiāgōng
主婦	主妇	zhǔfù
補	补	bǔ
地址	地址	dìzhǐ
大為	大为	dàwéi
抗爭	抗争	kàngzhēng
初步	初步	chūbù
碰	碰	pèng
佔有率	佔有率	zhànyǒulù
均衡	均衡	jūnhéng
抗戰	抗战	kàngzhàn
毒品	毒品	dúpǐn
甚至於	甚至于	shènzhìyū
盛行	盛行	shèngxíng
均衡	均衡	jūnhéng
訊號	讯号	xùnhào
服用	服用	fúyòng
班級	班级	bānjí
盛行	盛行	shèngxíng
授課	授课	shòukè
動人	动人	dòngrén
現狀	现状	xiànzhuàng
曲子	曲子	qǔzi5
外人	外人	wàirén
反抗	反抗	fǎnkàng
中原	中原	zhōngyuán
只得	只得	zhǐdé
刊登	刊登	kāndēng
蓬勃	蓬勃	péngbó
變	变	biàn
簽名	签名	qiānmíng
證明	证明	zhèngmíng
簽名	签名	qiānmíng
簽訂	签订	qiāndìng
聯誼會	联谊会	liányíhuì
簽訂	签订	qiāndìng
說來	说来	shuōlái
男友	男友	nányǒu
香	香	xiāng
演變	演变	yǎnbiàn
困擾	困扰	kùnrǎo
妥協	妥协	tuǒxié
長江	长江	chángjiāng
骨髓	骨髓	gǔsuí
神奇	神奇	shénqí
理	理	lǐ
靠近	靠近	kàojìn
神奇	神奇	shénqí
碗	碗	wǎn
溪	溪	xī
醒來	醒来	xǐnglái
演變	演变	yǎnbiàn
球隊	球队	qiúduì
妥協	妥协	tuǒxié
說謊	说谎	shuōhuǎng
臺中	台中	táizhōng
衝動	冲动	chōngdòng
總幹事	总干事	zǒnggànshì
寧可	宁可	níngkě
農場	农场	nóngchǎng
誠懇	诚恳	chéngkěn
回顧	回顾	huígù
心聲	心声	xīnshēng
華視	华视	huáshì
上司	上司	shàngsī
只	只	zhǐ
分辨	分辨	fēnbiàn
毛	毛	máo
主管	主管	zhǔguǎn
分手	分手	fēnshǒu
回顧	回顾	huígù
喜	喜	xǐ
田野	田野	tiányě
緊緊	紧紧	jǐnjǐn
一共	一共	yīgòng
型式	型式	xíngshì
有意思	有意思	yǒuyìsī
衝動	冲动	chōngdòng
然	然	rán
君	君	38139
具	具	jù
度假	度假	dùjià
根源	根源	gēnyuán
度假	度假	dùjià
島嶼	岛屿	dǎoyǔ
部位	部位	bùwèi
溫和	温和	wēnhé
細菌	细菌	xìjùn
情節	情节	qíngjié
情態	情态	qíngtài
造形	造形	zàoxíng
國防部	国防部	guófángbù
逾	逾	yū
殺死	杀死	shāsǐ
法案	法案	fǎàn
誠懇	诚恳	chéngkěn
語音	语音	yǔyīn
遠景	远景	yuǎnjǐng
適時	适时	shìshí
歌手	歌手	gēshǒu
熱情	热情	rèqíng
選購	选购	xuǎngòu
輻射	辐射	fúshè
親友	亲友	qīnyǒu
短暫	短暂	duǎnzhàn
順便	顺便	shùnbiàn
標準	标准	biāozhǔn
鑑定	鑑定	jiàndìng
選購	选购	xuǎngòu
盤勢	盘势	pánshì
出走	出走	chūzǒu
辭職	辞职	cízhí
不大	不大	bùdà
中小學	中小学	zhōngxiǎoxué
王子	王子	wángzǐ
考上	考上	kǎoshàng
鑑定	鑑定	jiàndìng
趨	趋	qū
辭職	辞职	cízhí
獅子	狮子	shīzi5
建物	建物	jiànwù
蘋果	苹果	píngguǒ
伸出	伸出	shēnchū
肢體	肢体	zhītǐ
神通	神通	shéntōng
地方性	地方性	dìfāngxìng
依舊	依旧	yījiù
仲介	仲介	zhòngjiè
折扣	折扣	zhékòu
仲介	仲介	zhòngjiè
保有	保有	bǎoyǒu
相繼	相继	xiāngjì
修行	修行	xiūxíng
省委	省委	shěngwěi
從而	从而	cóngér
自信	自信	zìxìn
專科	专科	zhuānkē
捐	捐	juān
竟是	竟是	jìngshì
航線	航线	hángxiàn
情結	情结	qíngjiē
率領	率领	shuàilǐng
細心	细心	xìxīn
旋律	旋律	xuánlù
最終	最终	zuìzhōng
掉	掉	diào
種植	种植	zhòngzhí
一般而言	一般而言	yībānéryán
生死	生死	shēngsǐ
化妝品	化妆品	huàzhuāngpǐn
大笑	大笑	dàxiào
適度	适度	shìdù
精彩	精彩	jīngcǎi
緩慢	缓慢	huǎnmàn
精彩	精彩	jīngcǎi
王國	王国	wángguó
頭	头	tóu
劇本	剧本	jùběn
包	包	bāo
末	末	mò
不明	不明	bùmíng
布	布	bù
月光	月光	yuèguāng
地價	地价	dìjià
轉業	转业	zhuǎnyè
講求	讲求	jiǎngqiú
護理	护理	hùlǐ
點頭	点头	diǎntóu
轉業	转业	zhuǎnyè
嘴巴	嘴巴	zuǐbā
家教	家教	jiājiào
盈餘	盈余	yíngyū
竹	竹	zhú
坦承	坦承	tǎnchéng
孤獨	孤独	gūdú
米	米	mǐ
孤獨	孤独	gūdú
種植	种植	zhòngzhí
表現出	表现出	biǎoxiànchū
孫	孙	sūn
侵犯	侵犯	qīnfàn
果實	果实	guǒshí
侵犯	侵犯	qīnfàn
郵票	邮票	yóupiào
自願	自愿	zìyuàn
挑選	挑选	tiāoxuǎn
會計	会计	kuàijì
勞力	劳力	láolì
費	费	fèi
新竹縣	新竹县	xīnzhúxiàn
運動會	运动会	yùndònghuì
堅強	坚强	jiānqiáng
目光	目光	mùguāng
堅強	坚强	jiānqiáng
偏偏	偏偏	piānpiān
挑選	挑选	tiāoxuǎn
給付	给付	jǐfù
靜態	静态	jìngtài
演唱會	演唱会	yǎnchànghuì
播出	播出	bòchū
經貿	经贸	jīngmào
播出	播出	bòchū
發射	发射	fāshè
幹什麼	干什么	gànshénmo5
發射	发射	fāshè
聘請	聘请	pìnqǐng
浪費	浪费	làngfèi
舞	舞	wǔ
無疑	无疑	wúyí
噪音	噪音	zàoyīn
與其	与其	yǔqí
學說	学说	xuéshuō
日圓	日圆	rìyuán
有力	有力	yǒulì
大道	大道	dàdào
午餐	午餐	wǔcān
中	中	zhòng
肌肉	肌肉	jīròu
禪	禅	chán
處境	处境	chǔjìng
繞	绕	rào
國營	国营	guóyíng
警告	警告	jǐnggào
住院	住院	zhùyuàn
先天	先天	xiāntiān
低於	低于	dīyū
夾	夹	jiá
找尋	找寻	zhǎoxún
移送	移送	yísòng
住院	住院	zhùyuàn
起床	起床	qǐchuáng
相容	相容	xiāngróng
是非	是非	shìfēi
南京	南京	nánjīng
省立	省立	shěnglì
浴室	浴室	yūshì
拆	拆	chāi
密度	密度	mìdù
壯觀	壮观	zhuàngguān
紀念館	纪念馆	jìniànguǎn
迷人	迷人	mírén
高雄縣	高雄县	gāoxióngxiàn
深遠	深远	shēnyuǎn
追查	追查	zhuīchá
眼神	眼神	yǎnshén
眷村	眷村	juàncūn
追查	追查	zhuīchá
粗	粗	cū
國有	国有	guóyǒu
開刀	开刀	kāidāo
邀集	邀集	yāojí
水墨	水墨	shuǐmò
激勵	激励	jīlì
選修	选修	xuǎnxiū
激勵	激励	jīlì
甄試	甄试	zhēnshì
標誌	标志	biāozhì
甲	甲	jiǎ
去	去	qù
可觀	可观	kěguān
下車	下车	xiàchē
讀經	读经	dújīng
提及	提及	tíjí
埋	埋	mái
仍舊	仍旧	réngjiù
奉獻	奉献	fèngxiàn
沿海	沿海	yánhǎi
任	任	rèn
安心	安心	ānxīn
奉獻	奉献	fèngxiàn
進展	进展	jìnzhǎn
厚	厚	hòu
農委會	农委会	nóngwěihuì
即為	即为	jíwéi
開啟	开启	kāiqǐ
立陶宛	立陶宛	lìtáowǎn
鄉公所	乡公所	xiānggōngsuǒ
開啟	开启	kāiqǐ
座談	座谈	zuòtán
門票	门票	ménpiào
一體	一体	yītǐ
裏面	裏面	lǐmiàn
試驗	试验	shìyàn
惡性	恶性	èxìng
鄉鎮	乡镇	xiāngzhèn
董事	董事	dǒngshì
跡象	迹象	jīxiàng
鞋子	鞋子	xiézi5
瑞典	瑞典	ruìdiǎn
導師	导师	dǎoshī
選定	选定	xuǎndìng
用以	用以	yòngyǐ
出任	出任	chūrèn
循	循	xún
不顧	不顾	búgù
絲	丝	sī
央行	央行	yāngháng
騷擾	骚扰	sāorǎo
田徑	田径	tiánjìng
在意	在意	zàiyì
循	循	xún
往來	往来	wǎnglái
慎重	慎重	shènzhòng
往來	往来	wǎnglái
何處	何处	héchù
事變	事变	shìbiàn
好	好	hào
老家	老家	lǎojiā
立法委員	立法委员	lìfǎwěiyuán
空軍	空军	kōngjūn
貢獻	贡献	gòngxiàn
負責任	负责任	fùzérèn
高	高	gāo
高大	高大	gāodà
終身	终身	zhōngshēn
缺失	缺失	quēshī
教會	教会	jiàohuì
啟發	启发	qǐfā
南韓	南韩	nánhán
抱持	抱持	bàochí
心願	心愿	xīnyuàn
裏	裏	lǐ
蔬菜	蔬菜	shūcài
零用錢	零用钱	língyòngqián
餐館	餐馆	cānguǎn
算了	算了	suànle5
錯	错	cuò
融資	融资	róngzī
舞者	舞者	wǔzhě
濃	浓	nóng
打擊	打击	dǎjí
考試	考试	kǎoshì
不堪	不堪	bùkān
氣象	气象	qìxiàng
冊	册	cè
縮小	缩小	suōxiǎo
爛	烂	làn
開幕	开幕	kāimù
人為	人为	rénwéi
弱勢	弱势	ruòshì
意外	意外	yìwài
行政院長	行政院长	xíngzhèngyuànzhǎng
物體	物体	wùtǐ
家事	家事	jiāshì
徐	徐	xú
拍照	拍照	pāizhào
病	病	bìng
東歐	东欧	dōngōu
頓時	顿时	dùnshí
刻	刻	kè
傳染	传染	chuánrǎn
開幕	开幕	kāimù
單身	单身	dānshēn
傳染	传染	chuánrǎn
景色	景色	jǐngsè
印	印	yìn
現任	现任	xiànrèn
外匯	外汇	wàihuì
測量	测量	cèliáng
緩緩	缓缓	huǎnhuǎn
右手	右手	yòushǒu
學費	学费	xuéfèi
頻道	频道	píndào
一味	一味	yīwèi
糖	糖	táng
製品	制品	zhìpǐn
數	数	shǔ
樓梯	楼梯	lóutī
天真	天真	tiānzhēn
嚮往	嚮往	xiàngwǎng
熱愛	热爱	rèài
山谷	山谷	shāngǔ
不一	不一	bùyī
卡片	卡片	kǎpiàn
女友	女友	nǔyǒu
引	引	yǐn
公聽會	公听会	gōngtīnghuì
出貨	出货	chūhuò
發作	发作	fāzuò
顯現	显现	xiǎnxiàn
戰績	战绩	zhànjī
嚮往	嚮往	xiàngwǎng
顧及	顾及	gùjí
藝人	艺人	yìrén
共享	共享	gòngxiǎng
亞運	亚运	yǎyùn
地毯	地毯	dìtǎn
熱愛	热爱	rèài
沒有	没有	méiyǒu
搖	摇	yáo
受理	受理	shòulǐ
肝癌	肝癌	gānyán
受理	受理	shòulǐ
老年人	老年人	lǎoniánrén
何	何	hé
保養	保养	bǎoyǎng
花朵	花朵	huāduǒ
促成	促成	cùchéng
屋子	屋子	wūzi5
桌子	桌子	zhuōzi5
成交量	成交量	chéngjiāoliàng
誇張	夸张	kuāzhāng
測量	测量	cèliáng
威力	威力	wēilì
部	部	bù
新人	新人	xīnrén
記者會	记者会	jìzhěhuì
書店	书店	shūdiàn
現金	现金	xiànjīn
消化	消化	xiāohuà
商機	商机	shāngjī
性教育	性教育	xìngjiàoyū
回想	回想	huíxiǎng
不解	不解	bùjiě
憲法	宪法	xiànfǎ
熟	熟	shú
外商	外商	wàishāng
談論	谈论	tánlùn
親人	亲人	qīnrén
可靠	可靠	kěkào
視窗	视窗	shìchuāng
變革	变革	biàngé
牌	牌	pái
圖說	图说	túshuō
主語	主语	zhǔyǔ
一貫	一贯	yīguàn
外觀	外观	wàiguān
瓦斯	瓦斯	wǎsī
主觀	主观	zhǔguān
關卡	关卡	guānkǎ
囉	囉	luó
邊界	边界	biānjiè
廳	厅	tīng
轉為	转为	zhuǎnwéi
抑制	抑制	yìzhì
減低	减低	jiǎndī
臉色	脸色	liǎnsè
怎能	怎能	zěnnéng
屍體	尸体	shītǐ
鳥兒	鸟儿	niǎoér
成就感	成就感	chéngjiùgǎn
美軍	美军	měijūn
師長	师长	shīzhǎng
河流	河流	héliú
容積	容积	róngjī
信徒	信徒	xìntú
品味	品味	pǐnwèi
客家	客家	kèjiā
要素	要素	yàosù
氧氣	氧气	yǎngqì
塑膠	塑胶	sùjiāo
乘	乘	chéng
信用卡	信用卡	xìnyòngkǎ
雷射	雷射	léishè
國建	国建	guójiàn
無不	无不	wúbù
處長	处长	chùzhǎng
採集	采集	cǎijí
書本	书本	shūběn
笑	笑	xiào
掀起	掀起	xiānqǐ
偏遠	偏远	piānyuǎn
親密	亲密	qīnmì
鋼鐵	钢铁	gāngtiě
燃燒	燃烧	ránshāo
雕刻	雕刻	diāokè
噴	喷	pēn
燃燒	燃烧	ránshāo
綠島	绿岛	lùdǎo
輪流	轮流	lúnliú
鄰近	邻近	línjìn
擊敗	击败	jíbài
結	结	jié
分發	分发	fēnfā
謹慎	谨慎	jǐnshèn
樂曲	乐曲	yuèqǔ
世上	世上	shìshàng
外婆	外婆	wàipó
巨人	巨人	jùrén
用功	用功	yònggōng
人情	人情	rénqíng
公務人員	公务人员	gōngwùrényuán
生日	生日	shēngrì
天才	天才	tiāncái
尺寸	尺寸	chǐcùn
覺	觉	jué
戀愛	恋爱	liànài
謹慎	谨慎	jǐnshèn
短線	短线	duǎnxiàn
停放	停放	tíngfàng
戀愛	恋爱	liànài
走入	走入	zǒurù
孝順	孝顺	xiàoshùn
多樣化	多样化	duōyànghuà
住家	住家	zhùjiā
步道	步道	bùdào
免得	免得	miǎnde5
股份	股份	gǔfèn
派員	派员	pàiyuán
知識分子	知识分子	zhīshìfènzǐ
停放	停放	tíngfàng
傳承	传承	chuánchéng
售	售	shòu
攻下	攻下	gōngxià
牽	牵	qiān
笨	笨	bèn
散步	散步	sànbù
蚊子	蚊子	wénzi5
愛國	爱国	àiguó
傳承	传承	chuánchéng
國旗	国旗	guóqí
異	异	yì
逃	逃	táo
基督教	基督教	jīdūjiào
常識	常识	chángshì
掌聲	掌声	zhǎngshēng
教訓	教训	jiàoxùn
愛國	爱国	àiguó
賓語	宾语	bīnyǔ
寫下	写下	xiěxià
總數	总数	zǒngshù
電腦化	电脑化	diànnǎohuà
聚	聚	jù
精確	精确	jīngquè
登山	登山	dēngshān
富有	富有	fùyǒu
登山	登山	dēngshān
學子	学子	xuézǐ
創下	创下	chuàngxià
簽約	签约	qiānyuē
電池	电池	diànchí
電腦化	电脑化	diànnǎohuà
出版社	出版社	chūbǎnshè
加快	加快	jiākuài
手槍	手枪	shǒuqiāng
工藝	工艺	gōngyì
台東	台东	táidōng
文書	文书	wénshū
繪圖	绘图	huìtú
簽約	签约	qiānyuē
蘇	苏	sū
換言之	换言之	huànyánzhī
中醫	中医	zhōngyī
尺度	尺度	chǐdù
再者	再者	zàizhě
火車站	火车站	huǒchēzhàn
僅僅	仅仅	jǐnjǐn
伸手	伸手	shēnshǒu
矣	矣	yǐ
老實	老实	lǎoshí
良心	良心	liángxīn
多重	多重	duōchóng
旺盛	旺盛	wàngshèng
股東	股东	gǔdōng
苗栗縣	苗栗县	miáolìxiàn
約	约	yuē
受訓	受训	shòuxùn
流失	流失	liúshī
專注	专注	zhuānzhù
作出	作出	zuòchū
流失	流失	liúshī
感興趣	感兴趣	gǎnxìngqù
連繫	连系	liánxì
富	富	fù
條款	条款	tiáokuǎn
專注	专注	zhuānzhù
商業區	商业区	shāngyèqū
甜	甜	tián
聊	聊	liáo
莫斯科	莫斯科	mòsīkē
神情	神情	shénqíng
連繫	连系	liánxì
擁抱	拥抱	yǒngbào
實地	实地	shídì
擁抱	拥抱	yǒngbào
學童	学童	xuétóng
湯	汤	tāng
右派	右派	yòupài
世間	世间	shìjiān
量產	量产	liàngchǎn
想	想	xiǎng
下去	下去	xiàqù
平	平	píng
之上	之上	zhīshàng
全民健保	全民健保	quánmínjiànbǎo
外交部	外交部	wàijiāobù
避開	避开	bìkāi
體型	体型	tǐxíng
週末	週末	zhōumò
得主	得主	dézhǔ
體育館	体育馆	tǐyūguǎn
左右	左右	zuǒyòu
相連	相连	xiānglián
堅決	坚决	jiānjué
罪嫌	罪嫌	zuìxián
行駛	行驶	xíngshǐ
兼任	兼任	jiānrèn
好聽	好听	hǎotīng
為期	为期	wéiqí
科	科	kē
美濃	美浓	měinóng
誠意	诚意	chéngyì
名利	名利	mínglì
遊憩	遊憩	yóuqì
持有	持有	chíyǒu
新光	新光	xīnguāng
最早	最早	zuìzǎo
眼鏡	眼镜	yǎnjìng
海面	海面	hǎimiàn
第	第	dì
客家人	客家人	kèjiārén
膨脹	膨胀	péngzhàng
單獨	单独	dāndú
蟲	虫	chóng
膨脹	膨胀	péngzhàng
解脫	解脱	jiětuō
隧道	隧道	suìdào
熊膽	熊胆	xióngdǎn
熱潮	热潮	rècháo
復	复	fù
學系	学系	xuéxì
鼓掌	鼓掌	gǔzhǎng
日記	日记	rìjì
日趨	日趋	rìqū
外出	外出	wàichū
出路	出路	chūlù
外出	外出	wàichū
解脫	解脱	jiětuō
鐘	钟	zhōng
此後	此后	cǐhòu
衝	冲	chōng
同伴	同伴	tóngbàn
供給	供给	gōngjǐ
事故	事故	shìgù
握	握	wò
受害	受害	shòuhài
表明	表明	biǎomíng
炒作	炒作	chǎozuò
香水	香水	xiāngshuǐ
氣溫	气温	qìwēn
供給	供给	gōngjǐ
炒作	炒作	chǎozuò
教	教	jiào
買到	买到	mǎidào
畝	亩	mǔ
畔	畔	pàn
現	现	xiàn
情趣	情趣	qíngqù
理工	理工	lǐgōng
造就	造就	zàojiù
跌	跌	dié
總算	总算	zǒngsuàn
群體	群体	qúntǐ
集體	集体	jítǐ
談起	谈起	tánqǐ
硬碟	硬碟	yìngdié
棒	棒	bàng
遊覽	游览	yóulǎn
效能	效能	xiàonéng
選舉	选举	xuǎnjǔ
遊覽	遊览	yóulǎn
確立	确立	quèlì
獨	独	dú
功效	功效	gōngxiào
月份	月份	yuèfèn
公益	公益	gōngyì
不知不覺	不知不觉	bùzhībùjué
失蹤	失踪	shīzōng
終究	终究	zhōngjiù
懷	怀	huái
租界	租界	zūjiè
失蹤	失踪	shīzōng
行事	行事	xíngshì
好笑	好笑	hǎoxiào
旁人	旁人	pángrén
淡	淡	dàn
佩服	佩服	pèifú
那樣	那样	nàyàng
交代	交代	jiāodài
岩石	岩石	yánshí
行事	行事	xíngshì
交代	交代	jiāodài
任教	任教	rènjiào
浮現	浮现	fúxiàn
冒	冒	mào
處在	处在	chǔzài
專欄	专栏	zhuānlán
因子	因子	yīnzǐ
風波	风波	fēngbō
處	处	chǔ
臭	臭	chòu
許可	许可	xǔkě
貨幣	货币	huòbì
垂直	垂直	chuízhí
泡	泡	pào
招牌	招牌	zhāopái
許可	许可	xǔkě
說起	说起	shuōqǐ
監測	监测	jiāncè
應邀	应邀	yìngyāo
監測	监测	jiāncè
語氣	语气	yǔqì
遠離	远离	yuǎnlí
遠處	远处	yuǎnchù
距離	距离	jùlí
新進	新进	xīnjìn
郵局	邮局	yóujú
辨識	辨识	biànshì
發言人	发言人	fāyánrén
辨識	辨识	biànshì
標本	标本	biāoběn
徵求	征求	zhēngqiú
糟	糟	zāo
遠離	远离	yuǎnlí
徵	征	zhēng
出自	出自	chūzì
市政	市政	shìzhèng
公寓	公寓	gōngyū
子孫	子孙	zǐsūn
晶片	晶片	jīngpiàn
法庭	法庭	fǎtíng
小學生	小学生	xiǎoxuéshēng
含	含	hán
武功	武功	wǔgōng
登上	登上	dēngshàng
刪除	删除	shānchú
局部	局部	júbù
作為	作为	zuòwéi
洛杉磯	洛杉矶	luòshānjī
相近	相近	xiāngjìn
派系	派系	pàixì
負起	负起	fùqǐ
直	直	zhí
發	发	fā
會議室	会议室	huìyìshì
交由	交由	jiāoyóu
留意	留意	liúyì
當事人	当事人	dāngshìrén
無論如何	无论如何	wúlùnrúhé
勒索	勒索	lēsuǒ
教書	教书	jiāoshū
粒	粒	lì
蛋白質	蛋白质	dànbáizhí
勒索	勒索	lēsuǒ
晚餐	晚餐	wǎncān
淪為	沦为	lúnwéi
餐	餐	cān
導遊	导遊	dǎoyóu
牆壁	墙壁	qiángbì
錄取	录取	lùqǔ
綠地	绿地	lùdì
榮民	荣民	róngmín
緊密	紧密	jǐnmì
錄取	录取	lùqǔ
戰火	战火	zhànhuǒ
線上	线上	xiànshàng
試辦	试办	shìbàn
發	发	fā
殼	壳	ké
試辦	试办	shìbàn
干預	干预	gānyū
飄	飘	piāo
過世	过世	guòshì
藥品	药品	yàopǐn
安置	安置	ānzhì
額外	额外	éwài
開出	开出	kāichū
露營	露营	lùyíng
簡報	简报	jiǎnbào
贊同	赞同	zàntóng
簡易	简易	jiǎnyì
贊同	赞同	zàntóng
巴士	巴士	bāshì
代表性	代表性	dàibiǎoxìng
下班	下班	xiàbān
用力	用力	yònglì
傾向	倾向	qīngxiàng
全然	全然	quánrán
露營	露营	lùyíng
簡易	简易	jiǎnyì
思索	思索	sīsuǒ
美食	美食	měishí
修飾	修饰	xiūshì
信賴	信赖	xìnlài
突出	突出	túchū
信賴	信赖	xìnlài
美學	美学	měixué
深受	深受	shēnshòu
美女	美女	měinǔ
吸毒	吸毒	xīdú
防火	防火	fánghuǒ
取出	取出	qǔchū
安置	安置	ānzhì
何在	何在	hézài
修養	修养	xiūyǎng
釣魚	钓鱼	diàoyū
後續	后续	hòuxù
約束	约束	yuēshù
探究	探究	tànjiù
消費	消费	xiāofèi
過世	过世	guòshì
詮釋	诠释	quánshì
私下	私下	sīxià
這樣子	这样子	zhèyàngzi5
穿梭	穿梭	chuānsuō
敏銳	敏锐	mǐnruì
約束	约束	yuēshù
高手	高手	gāoshǒu
核定	核定	hédìng
探究	探究	tànjiù
紐西蘭	纽西兰	niǒuxīlán
優待	优待	yōudài
散發	散发	sànfā
農會	农会	nónghuì
經銷	经销	jīngxiāo
麻醉	麻醉	mázuì
硬	硬	yìng
條約	条约	tiáoyuē
校友	校友	xiàoyǒu
淺	浅	qiǎn
產物	产物	chǎnwù
動工	动工	dònggōng
猶如	犹如	yóurú
台視	台视	táishì
習性	习性	xíxìng
推銷	推销	tuīxiāo
深厚	深厚	shēnhòu
晚會	晚会	wǎnhuì
動工	动工	dònggōng
避	避	bì
體會到	体会到	tǐhuìdào
瀕臨	濒临	bīnlín
凡事	凡事	fánshì
練習	练习	liànxí
才能	才能	cáinéng
縣立	县立	xiànlì
打球	打球	dǎqiú
手工	手工	shǒugōng
地檢署	地检署	dìjiǎnshǔ
位元	位元	wèiyuán
肉體	肉体	ròutǐ
付費	付费	fùfèi
擁擠	拥挤	yǒngjǐ
餘	余	yū
架設	架设	jiàshè
文藝	文艺	wényì
沿途	沿途	yántú
招待	招待	zhāodài
架設	架设	jiàshè
招待	招待	zhāodài
長官	长官	zhǎngguān
師傅	师傅	shīfù
哲學家	哲学家	zhéxuéjiā
夏威夷	夏威夷	xiàwēiyí
放置	放置	fàngzhì
沈重	沈重	chénzhòng
泥土	泥土	nítǔ
卷	卷	juàn
自我	自我	zìwǒ
見解	见解	jiànjiě
定期	定期	dìngqí
推銷	推销	tuīxiāo
里長	里长	lǐzhǎng
善良	善良	shànliáng
餘	余	yū
遺跡	遗迹	yíjī
演說	演说	yǎnshuō
稅	税	shuì
經銷	经销	jīngxiāo
遊樂	遊乐	yóulè
麻醉	麻醉	mázuì
評審	评审	píngshěn
董事會	董事会	dǒngshìhuì
病情	病情	bìngqíng
善良	善良	shànliáng
數位	数位	shùwèi
勇於	勇于	yǒngyū
商量	商量	shāngliáng
繁華	繁华	fánhuá
章程	章程	zhāngchéng
清新	清新	qīngxīn
強人	强人	qiángrén
降價	降价	jiàngjià
哪兒	哪儿	nǎér
致使	致使	zhìshǐ
內外	内外	nèiwài
明明	明明	míngmíng
院方	院方	yuànfāng
員警	员警	yuánjǐng
金門	金门	jīnmén
耶穌	耶稣	yēsū
倒	倒	dǎo
收拾	收拾	shōushí
自覺	自觉	zìjué
形	形	xíng
老板	老板	lǎobǎn
老年	老年	lǎonián
候鳥	候鸟	hòuniǎo
踢	踢	tī
反覆	反复	fǎnfù
力氣	力气	lìqì
不法	不法	bùfǎ
不惜	不惜	bùxí
營收	营收	yíngshōu
福建	福建	fújiàn
寬廣	宽广	kuānguǎng
總和	总和	zǒnghé
瓶頸	瓶颈	píngjǐng
縣政府	县政府	xiànzhèngfǔ
通	通	tōng
盡力	尽力	jìnlì
繁華	繁华	fánhuá
減肥	减肥	jiǎnféi
等候	等候	děnghòu
圍牆	围墙	wéiqiáng
隊員	队员	duìyuán
農曆	农历	nónglì
減肥	减肥	jiǎnféi
電玩	电玩	diànwán
增添	增添	zēngtiān
擴展	扩展	kuòzhǎn
心理學	心理学	xīnlǐxué
鎮	镇	zhèn
齣	齣	chū
輿論	舆论	yūlùn
編輯	编辑	biānjí
發電	发电	fādiàn
創造出	创造出	chuàngzàochū
悲哀	悲哀	bēiāi
擴展	扩展	kuòzhǎn
義賣	义卖	yìmài
悲觀	悲观	bēiguān
裝置	装置	zhuāngzhì
買賣	买卖	mǎimài
義賣	义卖	yìmài
管教	管教	guǎnjiào
靜	静	jìng
新知	新知	xīnzhī
舞會	舞会	wǔhuì
悲哀	悲哀	bēiāi
寢室	寝室	qǐnshì
管教	管教	guǎnjiào
遴選	遴选	línxuǎn
廣東	广东	guǎngdōng
遴選	遴选	línxuǎn
檢察官	检察官	jiǎncháguān
予	予	yǔ
手臂	手臂	shǒubì
一家人	一家人	yìjiārén
心頭	心头	xīntóu
土壤	土壤	tǔrǎng
大廳	大厅	dàtīng
檢索	检索	jiǎnsuǒ
南北	南北	nánběi
懷孕	怀孕	huáiyùn
顧	顾	gù
醫藥	医药	yīyào
印刷	印刷	yìnshuā
志願	志愿	zhìyuàn
列	列	liè
肝	肝	gān
印刷	印刷	yìnshuā
替代	替代	tìdài
使命	使命	shǐmìng
惡劣	恶劣	èliè
研判	研判	yánpàn
長遠	长远	chángyuǎn
葉子	叶子	yèzi5
惡劣	恶劣	èliè
男士	男士	nánshì
悲觀	悲观	bēiguān
郊區	郊区	jiāoqū
準備好	准备好	zhǔnbèihǎo
祭典	祭典	jìdiǎn
脫	脱	tuō
情事	情事	qíngshì
理	理	lǐ
持股	持股	chígǔ
面	面	miàn
油價	油价	yóujià
眾	众	zhòng
祇	祇	zhǐ
寶貝	宝贝	bǎobèi
可行性	可行性	kěxíngxìng
平行	平行	píngxíng
手腳	手脚	shǒujiǎo
主機板	主机板	zhǔjībǎn
寶	宝	bǎo
山水	山水	shānshuǐ
響起	响起	xiǎngqǐ
藍色	蓝色	lánsè
鐘頭	钟头	zhōngtóu
紓解	纾解	shūjiě
重	重	zhòng
青	青	qīng
急救	急救	jíjiù
表決	表决	biǎojué
相差	相差	xiāngchā
探親	探亲	tànqīn
阻礙	阻碍	zǔài
表決	表决	biǎojué
消滅	消灭	xiāomiè
透明	透明	tòumíng
連絡	连络	liánluò
追逐	追逐	zhuīzhú
不可或缺	不可或缺	bùkěhuòquē
急救	急救	jíjiù
同	同	tóng
壯	壮	zhuàng
老	老	lǎo
來回	来回	láihuí
君子	君子	jūnzǐ
放學	放学	fàngxué
判決	判决	pànjué
射	射	shè
合	合	hé
東海	东海	dōnghǎi
流浪	流浪	liúlàng
阻礙	阻碍	zǔài
流浪	流浪	liúlàng
孩童	孩童	háitóng
穿上	穿上	chuānshàng
異議	异议	yìyì
判決	判决	pànjué
整整	整整	zhěngzhěng
心境	心境	xīnjìng
榮總	荣总	róngzǒng
紓解	纾解	shūjiě
優雅	优雅	yōuyǎ
駕駛	驾驶	jiàshǐ
錄音	录音	lùyīn
圖像	图像	túxiàng
檢視	检视	jiǎnshì
遺忘	遗忘	yíwàng
檢視	检视	jiǎnshì
鋼	钢	gāng
實例	实例	shílì
優雅	优雅	yōuyǎ
山林	山林	shānlín
錄音	录音	lùyīn
煩惱	烦恼	fánnǎo
追逐	追逐	zhuīzhú
愛丁堡	爱丁堡	àidīngbǎo
期盼	期盼	qípàn
菩薩	菩萨	púsà
駕駛	驾驶	jiàshǐ
距	距	jù
說服	说服	shuìfú
裝飾	装饰	zhuāngshì
越南	越南	yuènán
象	象	xiàng
說服	说服	shuìfú
餅	饼	bǐng
總公司	总公司	zǒnggōngsī
極力	极力	jílì
大賽	大赛	dàsài
失落	失落	shīluò
觀看	观看	guānkàn
全壘打	全垒打	quánlěidǎ
撰寫	撰写	zhuànxiě
無情	无情	wúqíng
過關	过关	guòguān
傳奇	传奇	chuánqí
散	散	sàn
超商	超商	chāoshāng
魚類	鱼类	yūlèi
準確	准确	zhǔnquè
震撼	震撼	zhènhàn
摔	摔	shuāi
踏	踏	tà
震撼	震撼	zhènhàn
增設	增设	zēngshè
採訪	采访	cǎifǎng
歐	欧	ōu
常態	常态	chángtài
檢舉	检举	jiǎnjǔ
零件	零件	língjiàn
潛在	潜在	qiánzài
檢舉	检举	jiǎnjǔ
質量	质量	zhíliàng
橋樑	桥樑	liáng
撰寫	撰写	zhuànxiě
回答	回答	huídá
北韓	北韩	běihán
反倒	反倒	fǎndào
北美	北美	běiměi
主意	主意	zhǔyì
親身	亲身	qīnshēn
冰	冰	bīng
早餐	早餐	zǎocān
失落	失落	shīluò
更換	更换	gēnghuàn
改建	改建	gǎijiàn
利息	利息	lìxí
中央	中央	zhōngyāng
竹子	竹子	zhúzi5
升高	升高	shēnggāo
波動	波动	bōdòng
改建	改建	gǎijiàn
成交	成交	chéngjiāo
情人	情人	qíngrén
波動	波动	bōdòng
終止	终止	zhōngzhǐ
採訪	采访	cǎifǎng
終止	终止	zhōngzhǐ
野外	野外	yěwài
軟硬體	软硬体	ruǎnyìngtǐ
到來	到来	dàolái
規矩	规矩	guījǔ
俗稱	俗称	súchēng
況且	况且	kuàngqiě
風俗	风俗	fēngsú
到來	到来	dàolái
死者	死者	sǐzhě
村子	村子	cūnzi5
討好	讨好	tǎohǎo
難忘	难忘	nánwàng
警分局	警分局	jǐngfēnjú
藝文	艺文	yìwén
盼	盼	pàn
解說	解说	jiěshuō
藉口	藉口	jièkǒu
發燒	发烧	fāshāo
堂	堂	táng
狹窄	狭窄	xiázhǎi
通行	通行	tōngxíng
國代	国代	guódài
通行	通行	tōngxíng
殺害	杀害	shāhài
保母	保母	bǎomǔ
林立	林立	línlì
科長	科长	kēzhǎng
孫子	孙子	sūnzi5
籌碼	筹码	chóumǎ
放鬆	放松	fàngsōng
收購	收购	shōugòu
地下室	地下室	dìxiàshì
竹東	竹东	zhúdōng
佔地	佔地	zhàndì
抗體	抗体	kàngtǐ
砍	砍	kǎn
向量	向量	xiàngliàng
容許	容许	róngxǔ
存有	存有	cúnyǒu
免	免	miǎn
放鬆	放松	fàngsōng
軍方	军方	jūnfāng
面子	面子	miànzi5
視聽	视听	shìtīng
收購	收购	shōugòu
切	切	qiē
顯示器	显示器	xiǎnshìqì
邁進	迈进	màijìn
聽起來	听起来	tīngqǐlái
平凡	平凡	píngfán
口袋	口袋	kǒudài
分區	分区	fēnqū
大隊	大队	dàduì
功	功	gōng
心事	心事	xīnshì
意象	意象	yìxiàng
一般	一般	yībān
華麗	华丽	huálì
下山	下山	xiàshān
預備	预备	yūbèi
華麗	华丽	huálì
猶豫	犹豫	yóuyū
不見了	不见了	bújiànle5
殖民	殖民	zhímín
德	德	dé
對付	对付	duìfù
獎學金	奖学金	jiǎngxuéjīn
蔣介石	蒋介石	jiǎngjièshí
對照	对照	duìzhào
輝煌	辉煌	huīhuáng
慘	惨	cǎn
擅長	擅长	shàncháng
黑暗	黑暗	hēiàn
觀望	观望	guānwàng
媳婦	媳妇	xífù
露天	露天	lùtiān
觀摩	观摩	guānmó
韓	韩	hán
招收	招收	zhāoshōu
最愛	最爱	zuìài
移	移	yí
顯	显	xiǎn
描繪	描绘	miáohuì
當兵	当兵	dāngbīng
書面	书面	shūmiàn
商家	商家	shāngjiā
偏	偏	piān
彗星	彗星	huìxīng
添	添	tiān
盼望	盼望	pànwàng
描繪	描绘	miáohuì
盆地	盆地	péndì
無知	无知	wúzhī
招收	招收	zhāoshōu
冒險	冒险	màoxiǎn
乘客	乘客	chéngkè
制服	制服	zhìfú
行人	行人	xíngrén
任職	任职	rènzhí
光纖	光纤	guāngxiān
攻	攻	gōng
住處	住处	zhùchù
行李	行李	xínglǐ
攻勢	攻势	gōngshì
妨害	妨害	fánghài
恰當	恰当	qiàdàng
製成	制成	zhìchéng
轎車	轿车	jiàochē
驗證	验证	yànzhèng
觀摩	观摩	guānmó
市鎮	市镇	shìzhèn
心思	心思	xīnsī
心意	心意	xīnyì
少見	少见	shǎojiàn
無知	无知	wúzhī
化為	化为	huàwéi
趕到	赶到	gǎndào
廠牌	厂牌	chǎngpái
線索	线索	xiànsuǒ
嘉義	嘉义	jiāyì
道歉	道歉	dàoqiàn
經典	经典	jīngdiǎn
子弟	子弟	zǐdì
對面	对面	duìmiàn
脾氣	脾气	píqì
想像力	想像力	xiǎngxiànglì
補習	补习	bǔxí
運氣	运气	yùnqì
道歉	道歉	dàoqiàn
對比	对比	duìbǐ
數據機	数据机	shùjùjī
影展	影展	yǐngzhǎn
窗口	窗口	chuāngkǒu
一般來說	一般来说	yībānláishuō
山脈	山脉	shānmài
民主化	民主化	mínzhǔhuà
千萬	千万	qiānwàn
打架	打架	dǎjià
土著	土著	tǔzhù
充裕	充裕	chōngyū
靈感	灵感	línggǎn
鮮明	鲜明	xiānmíng
正當	正当	zhèngdāng
局勢	局势	júshì
細膩	细腻	xìnì
連帶	连带	liándài
務實	务实	wùshí
國畫	国画	guóhuà
推測	推测	tuīcè
欲望	欲望	yūwàng
頒發	颁发	bānfā
逐年	逐年	zhúnián
雨水	雨水	yǔshuǐ
配備	配备	pèibèi
亞太	亚太	yǎtài
奠定	奠定	diàndìng
大王	大王	dàiwáng
開展	开展	kāizhǎn
頒發	颁发	bānfā
細膩	细腻	xìnì
保健	保健	bǎojiàn
忽	忽	hū
存款	存款	cúnkuǎn
走向	走向	zǒuxiàng
妙	妙	miào
吾	吾	wú
垃圾場	垃圾场	lèsèchǎng
重重	重重	chóngchóng
亮麗	亮丽	liànglì
海關	海关	hǎiguān
美景	美景	měijǐng
果真	果真	guǒzhēn
首要	首要	shǒuyào
音樂廳	音乐厅	yīnyuètīng
苗栗	苗栗	miáolì
欺騙	欺骗	qīpiàn
幸好	幸好	xìnghǎo
辦桌	办桌	bànzhuō
欺騙	欺骗	qīpiàn
澳門	澳门	àomén
推測	推测	tuīcè
震盪	震荡	zhèndàng
暴露	暴露	pùlù
熱帶	热带	rèdài
戰事	战事	zhànshì
製	制	zhì
緣	缘	yuán
夕陽	夕阳	xìyáng
人道	人道	réndào
下課	下课	xiàkè
民主化	民主化	mínzhǔhuà
心胸	心胸	xīnxiōng
尺	尺	chǐ
諮商	谘商	zīshāng
想不到	想不到	xiǎngbúdào
感官	感官	gǎnguān
號召	号召	hàozhào
開展	开展	kāizhǎn
諮商	谘商	zīshāng
週年	週年	zhōunián
緣故	缘故	yuángù
道家	道家	dàojiā
震盪	震荡	zhèndàng
號稱	号称	hàochēng
睡著	睡着	shuìzháo
增長	增长	zēngzhǎng
報案	报案	bàoàn
黑白	黑白	hēibái
號召	号召	hàozhào
充足	充足	chōngzú
疼痛	疼痛	téngtòng
簡稱	简称	jiǎnchēng
髒	脏	zāng
簽署	签署	qiānshǔ
簽證	签证	qiānzhèng
體操	体操	tǐcāo
搬	搬	bān
真誠	真诚	zhēnchéng
衰退	衰退	shuāituì
陳情	陈情	chénqíng
高職	高职	gāozhí
絕	绝	jué
鄉民	乡民	xiāngmín
新埔	新埔	xīnbǔ
無力	无力	wúlì
媒介	媒介	méijiè
鄭	郑	zhèng
貴	贵	guì
計有	计有	jìyǒu
無從	无从	wúcóng
園地	园地	yuándì
燦爛	灿烂	cànlàn
墨西哥	墨西哥	mòxīgē
課本	课本	kèběn
抗日	抗日	kàngrì
領土	领土	lǐngtǔ
尷尬	尴尬	gāngà
齊全	齐全	qíquán
榮獲	荣获	rónghuò
學界	学界	xuéjiè
運	运	yùn
定案	定案	dìngàn
地域	地域	dìyū
外部	外部	wàibù
門診	门诊	ménzhěn
存取	存取	cúnqǔ
宜蘭縣	宜兰县	yílánxiàn
列車	列车	lièchē
多樣	多样	duōyàng
抗日	抗日	kàngrì
存取	存取	cúnqǔ
來訪	来访	láifǎng
成份	成份	chéngfèn
衰退	衰退	shuāituì
來訪	来访	láifǎng
連上	连上	liánshàng
計較	计较	jìjiào
金瓜石	金瓜石	jīnguāshí
門診	门诊	ménzhěn
後遺症	后遗症	hòuyízhèng
玫瑰	玫瑰	méiguī
科學園區	科学园区	kēxuéyuánqū
負荷	负荷	fùhè
包裝	包装	bāozhuāng
派出所	派出所	pàichūsuǒ
抬	抬	tái
流氓	流氓	liúmáng
尷尬	尴尬	gāngà
言語	言语	yányǔ
升值	升值	shēngzhí
四川	四川	sìchuān
不及	不及	bùjí
加油	加油	jiāyóu
外型	外型	wàixíng
大氣	大气	dàqì
應該	应该	yīnggāi
聆聽	聆听	língtīng
猛	猛	měng
素材	素材	sùcái
深思	深思	shēnsī
脖子	脖子	bózi5
書包	书包	shūbāo
捧	捧	pěng
理所當然	理所当然	lǐsuǒdāngrán
劃分	划分	huàfēn
通	通	tōng
國際性	国际性	guójìxìng
規律	规律	guīlù
速率	速率	sùlù
省籍	省籍	shěngjí
稀飯	稀饭	xīfàn
阿里山	阿里山	ālǐshān
發音	发音	fāyīn
極度	极度	jídù
劃分	划分	huàfēn
照明	照明	zhàomíng
開放式	开放式	kāifàngshì
禁忌	禁忌	jìnjì
場景	场景	chángyǐng
照明	照明	zhàomíng
光碟機	光碟机	guāngdiéjī
吸引力	吸引力	xīyǐnlì
光芒	光芒	guāngmáng
批判	批判	pīpàn
光明	光明	guāngmíng
行走	行走	xíngzǒu
低廉	低廉	dīlián
改成	改成	gǎichéng
冷氣	冷气	lěngqì
冰箱	冰箱	bīngxiāng
兼具	兼具	jiānjù
多餘	多余	duōyū
致詞	致词	zhìcí
多多	多多	duōduō
自私	自私	zìsī
親近	亲近	qīnjìn
保證	保证	bǎozhèng
洽詢	洽询	qiàxún
保	保	bǎo
附	附	fù
致詞	致词	zhìcí
辦事處	办事处	bànshìchù
封面	封面	fēngmiàn
自稱	自称	zìchēng
小子	小子	xiǎozi5
鑑於	鉴于	jiànyū
瞪	瞪	dèng
驅動	驱动	qūdòng
叢林	丛林	cónglín
顯示出	显示出	xiǎnshìchū
卅	卅	sà
方針	方针	fāngzhēn
考古學	考古学	kǎogǔxué
上游	上游	shàngyóu
蟑螂	蟑螂	zhāngláng
戶籍	户籍	hùjí
公家	公家	gōngjiā
廢紙	废纸	fèizhǐ
精華	精华	jīnghuá
獲利	获利	huòlì
嗩吶	唢呐	suǒnà
增多	增多	zēngduō
醒	醒	xǐng
增多	增多	zēngduō
自私	自私	zìsī
說明會	说明会	shuōmínghuì
蓮花	莲花	liánhuā
下游	下游	xiàyóu
劇情	剧情	jùqíng
回檔	回档	huídǎng
匹	匹	pī
一連	一连	yīlián
召集	召集	zhàojí
正視	正视	zhèngshì
擦	擦	cā
廢除	废除	fèichú
蔣公	蒋公	jiǎnggōng
環保署	环保署	huánbǎoshǔ
實體	实体	shítǐ
寫實	写实	xiěshí
搖頭	摇头	yáotóu
婆婆	婆婆	pópó
介詞	介词	jiècí
牛肉	牛肉	nióuròu
父子	父子	fùzǐ
片子	片子	piànzi5
充電	充电	chōngdiàn
士兵	士兵	shìbīng
旗下	旗下	qíxià
本能	本能	běnnéng
學人	学人	xuérén
譜	谱	pǔ
賣給	卖给	màigěi
戰略	战略	zhànluè
選票	选票	xuǎnpiào
政經	政经	zhèngjīng
副院長	副院长	fùyuànzhǎng
國產	国产	guóchǎn
曲目	曲目	qǔmù
就此	就此	jiùcǐ
強度	强度	qiángdù
掩埋場	掩埋场	yǎnmáichǎng
政務	政务	zhèngwù
風情	风情	fēngqíng
前後	前后	qiánhòu
坐下來	坐下来	zuòxiàlái
奇妙	奇妙	qímiào
居多	居多	jūduō
有線電視	有线电视	yǒuxiàndiànshì
絕種	绝种	juézhǒng
留給	留给	liúgěi
男朋友	男朋友	nánpéngyǒu
違背	违背	wéibèi
開課	开课	kāikè
陽台	阳台	yángtái
嫌犯	嫌犯	xiánfàn
處分	处分	chǔfèn
刺	刺	cì
把握	把握	bǎwò
朱	朱	zhū
吃虧	吃亏	chīkuī
進軍	进军	jìnjūn
盲目	盲目	mángmù
長輩	长辈	zhǎngbèi
病房	病房	bìngfáng
社交	社交	shèjiāo
破產	破产	pòchǎn
採行	采行	cǎixíng
起	起	qǐ
莫	莫	mò
船隻	船只	chuánzhī
都會區	都会区	dūhuìqū
習俗	习俗	xísú
音量	音量	yīnliàng
自	自	zì
破產	破产	pòchǎn
托兒所	托儿所	tuōérsuǒ
台獨	台独	táidú
發育	发育	fāyū
足球	足球	zúqiú
目睹	目睹	mùdǔ
名牌	名牌	míngpái
沙烏地阿拉伯	沙乌地阿拉伯	shāwūdìālābó
店面	店面	diànmiàn
沙	沙	shā
哼	哼	hēng
界限	界限	jièxiàn
枝	枝	zhī
紅樹林	红树林	hóngshùlín
後人	后人	hòurén
容積率	容积率	róngjīlù
招	招	zhāo
何不	何不	hébù
一口氣	一口气	yīkǒuqì
共同體	共同体	gòngtóngtǐ
錶	表	biǎo
漫長	漫长	màncháng
精英	精英	jīngyīng
暫停	暂停	zhàntíng
整頓	整顿	zhěngdùn
暗示	暗示	ànshì
外公	外公	wàigōng
提議	提议	tíyì
露	露	lù
鎮長	镇长	zhènzhǎng
警察局	警察局	jǐngchájú
騎士	骑士	qíshì
聯軍	联军	liánjūn
繼承	继承	jìchéng
雙向	双向	shuāngxiàng
日軍	日军	rìjūn
報酬	报酬	bàochóu
發育	发育	fāyū
程	程	chéng
新任	新任	xīnrèn
開花	开花	kāihuā
慈悲	慈悲	cíbēi
飼養	饲养	sìyǎng
棲息	栖息	qīxí
試試	试试	shìshì
詮釋	诠释	quánshì
絕大多數	绝大多数	juédàduōshù
報到	报到	bàodào
損失	损失	sǔnshī
極端	极端	jíduān
愛護	爱护	àihù
微	微	wéi
腦海	脑海	nǎohǎi
琴	琴	qín
飼養	饲养	sìyǎng
動向	动向	dòngxiàng
精美	精美	jīngměi
班長	班长	bānzhǎng
創立	创立	chuànglì
微笑	微笑	wéixiào
腦筋	脑筋	nǎojīn
雷達	雷达	léidá
墨	墨	mò
整修	整修	zhěngxiū
踩	踩	cǎi
實在	实在	shízài
精美	精美	jīngměi
發現	发现	fāxiàn
整修	整修	zhěngxiū
報表	报表	bàobiǎo
諷刺	讽刺	fèngcì
中毒	中毒	zhòngdú
下跌	下跌	xiàdié
切除	切除	qiēchú
片段	片段	piànduàn
平方公尺	平方公尺	píngfānggōngchǐ
公約	公约	gōngyuē
火災	火灾	huǒzāi
不好意思	不好意思	bùhǎoyìsī
趨向	趋向	qūxiàng
櫻花	樱花	yīnghuā
諷刺	讽刺	fèngcì
備受	备受	bèishòu
來往	来往	láiwǎng
法	法	fà
災害	灾害	zāihài
何以	何以	héyǐ
奇特	奇特	qítè
沙國	沙国	shāguó
待	待	dāi
抱	抱	bào
俄羅斯	俄罗斯	èluósī
當中	当中	dāngzhōng
性情	性情	xìngqíng
注意力	注意力	zhùyìlì
備受	备受	bèishòu
做完	做完	zuòwán
基準	基准	jīzhǔn
規程	规程	guīchéng
傘	伞	sǎn
打敗	打败	dǎbài
資訊業	资讯业	zīxùnyè
創立	创立	chuànglì
微笑	微笑	wéixiào
買賣	买卖	mǎimài
意念	意念	yìniàn
穿過	穿过	chuānguò
趨向	趋向	qūxiàng
精密	精密	jīngmì
廣義	广义	guǎngyì
著急	着急	zhāojí
收回	收回	shōuhuí
補償	补偿	bǔcháng
欺負	欺负	qīfù
跌破	跌破	diépò
區隔	区隔	qūgé
揭開	揭开	jiēkāi
選用	选用	xuǎnyòng
盛	盛	shèng
得很	得很	de5hěn
株	株	zhū
被單	被单	bèidān
財經	财经	cáijīng
患	患	huàn
婚紗	婚纱	hūnshā
教官	教官	jiàoguān
感冒	感冒	gǎnmào
干涉	干涉	gānshè
關閉	关闭	guānbì
聯隊	联队	liánduì
有一點	有一点	yǒuyìdiǎn
不符	不符	bùfú
小鳥	小鸟	xiǎoniǎo
世代	世代	shìdài
調適	调适	tiáoshì
化妝	化妆	huàzhuāng
融入	融入	róngrù
本事	本事	běnshì
龍山寺	龙山寺	lóngshānsì
調適	调适	tiáoshì
摧毀	摧毁	cuīhuǐ
對岸	对岸	duìàn
濃度	浓度	nóngdù
選用	选用	xuǎnyòng
稀有	稀有	xīyǒu
充斥	充斥	chōngchì
戒	戒	jiè
性行為	性行为	xìngxíngwéi
界定	界定	jièdìng
毒	毒	dú
抵抗	抵抗	dǐkàng
前任	前任	qiánrèn
各行各業	各行各业	gèhánggèyè
良性	良性	liángxìng
伴隨	伴随	bànsuí
抵抗	抵抗	dǐkàng
依靠	依靠	yīkào
來不及	来不及	láibùjí
州	州	zhōu
依靠	依靠	yīkào
異性	异性	yìxìng
官僚	官僚	guānliáo
猴子	猴子	hóuzi5
再說	再说	zàishuō
伴隨	伴随	bànsuí
收回	收回	shōuhuí
肩膀	肩膀	jiānbǎng
疏忽	疏忽	shūhū
白雲	白云	báiyún
契機	契机	qìjī
通俗	通俗	tōngsú
高潮	高潮	gāocháo
桃園縣	桃园县	táoyuánxiàn
連戰	连战	liánzhàn
清理	清理	qīnglǐ
疏忽	疏忽	shūhū
動用	动用	dòngyòng
表現出來	表现出来	biǎoxiànchūlái
區隔	区隔	qūgé
海豚	海豚	hǎitún
抵	抵	dǐ
迫切	迫切	pòqiè
金屬	金属	jīnshǔ
恭喜	恭喜	gōngxǐ
書寫	书写	shūxiě
脂肪	脂肪	zhīfáng
書寫	书写	shūxiě
捐贈	捐赠	juānzèng
展望	展望	zhǎnwàng
處罰	处罚	chǔfá
接觸到	接触到	jiēchùdào
捐贈	捐赠	juānzèng
眼見	眼见	yǎnjiàn
捨不得	舍不得	shěbùdé
帳	帐	zhàng
記載	记载	jìzài
栽培	栽培	zāipéi
野心	野心	yěxīn
書畫	书画	shūhuà
炎熱	炎热	yánrè
併購	并购	bìnggòu
除	除	chú
專利權	专利权	zhuānlìquán
迎	迎	yíng
陪同	陪同	péitóng
改選	改选	gǎixuǎn
老舊	老旧	lǎojiù
老子	老子	lǎozǐ
身影	身影	shēnyǐng
改選	改选	gǎixuǎn
海灘	海滩	hǎitān
便民	便民	biànmín
所幸	所幸	suǒxìng
空白	空白	kòngbái
展望	展望	zhǎnwàng
知名度	知名度	zhīmíngdù
師院	师院	shīyuàn
成大	成大	chéngdà
爆炸	爆炸	bàozhà
落地	落地	luòdì
童話	童话	tónghuà
跨國	跨国	kuàguó
陪同	陪同	péitóng
乃至	乃至	nǎizhì
火山	火山	huǒshān
乃至	乃至	nǎizhì
付款	付款	fùkuǎn
工業化	工业化	gōngyèhuà
麻雀	麻雀	máquè
大麻	大麻	dàmá
路	路	lù
比重	比重	bǐzhòng
爆炸	爆炸	bàozhà
護士	护士	hùshì
蹺家	跷家	qiàojiā
艱苦	艰苦	jiānkǔ
艱難	艰难	jiānnán
蟋蟀	蟋蟀	xīshuài
艱難	艰难	jiānnán
艱苦	艰苦	jiānkǔ
栽培	栽培	zāipéi
士氣	士气	shìqì
雕像	雕像	diāoxiàng
平地	平地	píngdì
備	备	bèi
祖國	祖国	zǔguó
寸	寸	cùn
大選	大选	dàxuǎn
遵循	遵循	zūnxún
集	集	jí
零售	零售	língshòu
港口	港口	gǎngkǒu
壓制	压制	yāzhì
療法	疗法	liáofǎ
獲勝	获胜	huòshèng
新建	新建	xīnjiàn
壓制	压制	yāzhì
農地	农地	nóngdì
遷	迁	qiān
感性	感性	gǎnxìng
黑人	黑人	hēirén
落在	落在	luòzài
靜坐	静坐	jìngzuò
總會	总会	zǒnghuì
請假	请假	qǐngjià
美化	美化	měihuà
香	香	xiāng
急速	急速	jísù
建國	建国	jiànguó
約定	约定	yuēdìng
生機	生机	shēngjī
查證	查证	cházhèng
荒謬	荒谬	huāngmiù
約定	约定	yuēdìng
家園	家园	jiāyuán
前景	前景	qiánjǐng
查證	查证	cházhèng
建國	建国	jiànguó
夜市	夜市	yèshì
卓越	卓越	zhuóyuè
呎	呎	chǐ
制裁	制裁	zhìcái
更改	更改	gēnggǎi
換上	换上	huànshàng
烏托邦	乌托邦	wūtuōbāng
罷工	罢工	bàgōng
瓦解	瓦解	wǎjiě
應變	应变	yìngbiàn
影印	影印	yǐngyìn
窮人	穷人	qióngrén
寫出	写出	xiěchū
電機	电机	diànjī
應變	应变	yìngbiàn
劇烈	剧烈	jùliè
駱駝	骆驼	luòtuó
電廠	电厂	diànchǎng
校門	校门	xiàomén
複句	复句	fùjù
率	率	shuài
診所	诊所	zhěnsuǒ
準則	准则	zhǔnzé
畫展	画展	huàzhǎn
絕望	绝望	juéwàng
期刊	期刊	qíkān
裁判	裁判	cáipàn
婦人	妇人	fùrén
神祕	神祕	shénmì
荒謬	荒谬	huāngmiù
理會	理会	lǐhuì
院子	院子	yuànzi5
全身	全身	quánshēn
罷工	罢工	bàgōng
仰賴	仰赖	yǎnglài
絕望	绝望	juéwàng
佈置	佈置	bùzhì
更改	更改	gēnggǎi
佈置	佈置	bùzhì
幼蟲	幼虫	yòuchóng
瓦解	瓦解	wǎjiě
入境	入境	rùjìng
古董	古董	gǔdǒng
蘇	苏	sū
嚴厲	严厉	yánlì
識	识	shì
禪師	禅师	chánshī
蔡	蔡	cài
闢	闢	pì
差點	差点	chādiǎn
健保	健保	jiànbǎo
美化	美化	měihuà
表格	表格	biǎogé
穿著	穿着	chuānzhuó
建檔	建档	jiàndǎng
思維	思维	sīwéi
系主任	系主任	xìzhǔrèn
抗拒	抗拒	kàngjù
身長	身长	shēncháng
抗拒	抗拒	kàngjù
低頭	低头	dītóu
往事	往事	wǎngshì
毀	毁	huǐ
惡	恶	è
華裔	华裔	huáyì
窗戶	窗户	chuānghù
隕石	陨石	yǔnshí
週刊	週刊	zhōukān
德	德	dé
無可	无可	wúkě
陽明山	阳明山	yángmíngshān
發表會	发表会	fābiǎohuì
高峰	高峰	gāofēng
歌劇	歌剧	gējù
莊嚴	庄严	zhuāngyán
祝福	祝福	zhùfú
酒精	酒精	jiǔjīng
毫無	毫无	háowú
出入	出入	chūrù
布條	布条	bùtiáo
本土化	本土化	běntǔhuà
史料	史料	shǐliào
失誤	失误	shīwù
再生	再生	zàishēng
中外	中外	zhōngwài
預約	预约	yūyuē
文人	文人	wénrén
總務處	总务处	zǒngwùchù
出入	出入	chūrù
天性	天性	tiānxìng
拓寬	拓宽	tuòkuān
巧	巧	qiǎo
務必	务必	wùbì
預約	预约	yūyuē
蔣	蒋	jiǎng
反射	反射	fǎnshè
示威	示威	shìwēi
返國	返国	fǎnguó
角逐	角逐	jiǎozhú
休假	休假	xiūjià
放進	放进	fàngjìn
好意思	好意思	hǎoyìsī
休假	休假	xiūjià
要件	要件	yàojiàn
成群	成群	chéngqún
建材	建材	jiàncái
示威	示威	shìwēi
地獄	地狱	dìyū
光榮	光荣	guāngróng
協辦	协办	xiébàn
協調會	协调会	xiétiáohuì
目的地	目的地	mùdìdì
別墅	别墅	biéshù
迫使	迫使	pòshǐ
徘徊	徘徊	páihuái
啟示	启示	qǐshì
莊嚴	庄严	zhuāngyán
降	降	jiàng
贈送	赠送	zèngsòng
面談	面谈	miàntán
角逐	角逐	jiǎozhú
便於	便于	biànyū
傢伙	傢伙	jiāhuǒ
返國	返国	fǎnguó
家用	家用	jiāyòng
風暴	风暴	fēngbào
秒鐘	秒钟	miǎozhōng
柏林	柏林	bólín
英國人	英国人	yīngguórén
面談	面谈	miàntán
拓寬	拓宽	tuòkuān
嚴謹	严谨	yánjǐn
還	还	huán
再生	再生	zàishēng
朝向	朝向	cháoxiàng
震驚	震惊	zhènjīng
繁忙	繁忙	fánmáng
歌謠	歌谣	gēyáo
預測	预测	yūcè
震驚	震惊	zhènjīng
電視機	电视机	diànshìjī
標榜	标榜	biāobǎng
澄清	澄清	chéngqīng
繁忙	繁忙	fánmáng
工作者	工作者	gōngzuòzhě
嫁	嫁	jià
虛無	虚无	xūwú
評核	评核	pínghé
解嚴	解严	jiěyán
路徑	路径	lùjìng
遊樂區	遊乐区	yóulèqū
澄清	澄清	chéngqīng
心血	心血	xīnxiě
關節	关节	guānjié
邁入	迈入	màirù
讚美	讚美	zànměi
關	关	guān
賽程	赛程	sàichéng
支配	支配	zhīpèi
小提琴	小提琴	xiǎotíqín
誤解	误解	wùjiě
人民日報	人民日报	rénmínrìbào
台語	台语	táiyǔ
不定	不定	búdìng
山坡	山坡	shānpō
不等	不等	bùděng
大雨	大雨	dàyǔ
小鎮	小镇	xiǎozhèn
上來	上来	shànglái
引擎	引擎	yǐnqíng
解嚴	解严	jiěyán
木材	木材	mùcái
芝加哥	芝加哥	zhījiāgē
易於	易于	yìyū
後代	后代	hòudài
拚命	拚命	pànmìng
祈禱	祈祷	qídǎo
板橋	板桥	bǎn
拜拜	拜拜	bàibài
祈禱	祈祷	qídǎo
殿堂	殿堂	diàntáng
相傳	相传	xiāngchuán
偵訊	侦讯	zhēnxùn
汙染	汙染	wūrǎn
更何況	更何况	gènghékuàng
好	好	hǎo
助	助	zhù
取材	取材	qǔcái
抽出	抽出	chōuchū
重疊	重叠	chóngdié
長久以來	长久以来	chángjiǔyǐlái
骨頭	骨头	gǔtóu
感想	感想	gǎnxiǎng
索取	索取	suǒqǔ
起初	起初	qǐchū
神聖	神圣	shénshèng
探	探	tàn
配	配	pèi
莫大	莫大	mòdà
美元	美元	měiyuán
參展	参展	cānzhǎn
前衛	前卫	qiánwèi
淚	泪	lèi
都會	都会	dūhuì
閃	闪	shǎn
參展	参展	cānzhǎn
強勁	强劲	qiángjìn
清醒	清醒	qīngxǐng
拿去	拿去	náqù
華僑	华侨	huá
消基會	消基会	xiāojīhuì
活躍	活跃	huóyuè
規範	规范	guīfàn
衍生	衍生	yǎnshēng
東北	东北	dōngběi
房價	房价	fángjià
異國	异国	yìguó
巢	巢	cháo
覓食	觅食	mìshí
設廠	设厂	shèchǎng
更多	更多	gèngduō
通車	通车	tōngchē
明知	明知	míngzhī
特權	特权	tèquán
通話	通话	tōnghuà
起步	起步	qǐbù
拿出來	拿出来	náchūlái
通話	通话	tōnghuà
堆	堆	duī
率先	率先	shuàixiān
起步	起步	qǐbù
設廠	设厂	shèchǎng
地坪	地坪	dìpíng
自認	自认	zìrèn
投注	投注	tóuzhù
羽毛	羽毛	yǔmáo
巡視	巡视	xúnshì
供水	供水	gōngshuǐ
好比	好比	hǎobǐ
求	求	qiú
紅血球	红血球	hóngxiěqiú
血壓	血压	xiěyā
社會局	社会局	shèhuìjú
巡視	巡视	xúnshì
好萊塢	好莱坞	hǎoláiwù
成品	成品	chéngpǐn
相對論	相对论	xiāngduìlùn
病變	病变	bìngbiàn
建築	建筑	jiànzhú
衍生	衍生	yǎnshēng
雄	雄	xióng
供水	供水	gōngshuǐ
不平	不平	bùpíng
通車	通车	tōngchē
總部	总部	zǒngbù
遭遇	遭遇	zāoyū
遷移	迁移	qiānyí
腐敗	腐败	fǔbài
不平	不平	bùpíng
市中心	市中心	shìzhōngxīn
公所	公所	gōngsuǒ
歌唱	歌唱	gēchàng
不以為然	不以为然	bùyǐwéirán
說出來	说出来	shuōchūlái
出色	出色	chūsè
出發點	出发点	chūfādiǎn
工業局	工业局	gōngyèjú
土木	土木	tǔmù
中藥	中药	zhōngyào
工夫	工夫	gōngfū
藍圖	蓝图	lántú
糟糕	糟糕	zāogāo
女朋友	女朋友	nǔpéngyǒu
腐敗	腐败	fǔbài
忍	忍	rěn
發佈	发佈	fābù
搬到	搬到	bāndào
菁英	菁英	jīngyīng
頒獎	颁奖	bānjiǎng
喲	哟	yāo
遷移	迁移	qiānyí
輪	轮	lún
起碼	起码	qǐmǎ
親眼	亲眼	qīnyǎn
談話	谈话	tánhuà
綽號	绰号	chuòhào
歌唱	歌唱	gēchàng
疑慮	疑虑	yílù
頻寬	频宽	pínkuān
寧願	宁愿	níngyuàn
餐飲	餐饮	cānyǐn
善惡	善恶	shànè
定義	定义	dìngyì
高市	高市	gāoshì
起飛	起飞	qǐfēi
追尋	追寻	zhuīxún
起飛	起飞	qǐfēi
國度	国度	guódù
拿	拿	ná
深感	深感	shēngǎn
神明	神明	shénmíng
情侶	情侣	qínglǔ
透過	透过	tòuguò
進場	进场	jìnchǎng
擔憂	担忧	dānyōu
聖經	圣经	shèngjīng
崩潰	崩溃	bēngkuì
意圖	意图	yìtú
節約	节约	jiéyuē
訴說	诉说	sùshuō
善意	善意	shànyì
黑暗	黑暗	hēiàn
傷口	伤口	shāngkǒu
節約	节约	jiéyuē
黑面琵鷺	黑面琵鹭	hēimiànpílù
援助	援助	yuánzhù
進場	进场	jìnchǎng
維他命	维他命	wéitāmìng
運轉	运转	yùnzhuǎn
指稱	指称	zhǐchēng
乖	乖	guāi
改編	改编	gǎibiān
決心	决心	juéxīn
忠告	忠告	zhōnggào
改編	改编	gǎibiān
佳作	佳作	jiāzuò
法師	法师	fǎshī
刻	刻	kē
彷彿	彷彿	fǎngfú
指稱	指称	zhǐchēng
面孔	面孔	miànkǒng
浪潮	浪潮	làngcháo
研商	研商	yánshāng
貫徹	贯彻	guànchè
美商	美商	měishāng
香蕉	香蕉	xiāngjiāo
香味	香味	xiāngwèi
信號	信号	xìnhào
恐龍	恐龙	kǒnglóng
研商	研商	yánshāng
流血	流血	liúxiě
長城	长城	chángchéng
食堂	食堂	shítáng
最少	最少	zuìshǎo
斜	斜	xié
業餘	业余	yèyū
空前	空前	kōngqián
寶座	宝座	bǎozuò
運轉	运转	yùnzhuǎn
撥	拨	bō
體貼	体贴	tǐtiē
轉身	转身	zhuǎnshēn
壞事	坏事	huàishì
大展	大展	dàzhǎn
玉	玉	yū
民營化	民营化	mínyínghuà
大舉	大举	dàjǔ
上揚	上扬	shàngyáng
大半	大半	dàbàn
不動產	不动产	búdòngchǎn
一塊	一块	yīkuài
聚會	聚会	jùhuì
公關	公关	gōngguān
寫成	写成	xiěchéng
鼓舞	鼓舞	gǔwǔ
聯合會	联合会	liánhéhuì
學長	学长	xuézhǎng
樹枝	树枝	shùzhī
綠化	绿化	lùhuà
頭部	头部	tóubù
綠化	绿化	lùhuà
賭博	赌博	dǔbó
中途	中途	zhōngtú
鼓舞	鼓舞	gǔwǔ
貪污	贪污	tānwū
高明	高明	gāomíng
深入	深入	shēnrù
棄	弃	qì
財源	财源	cáiyuán
處置	处置	chǔzhì
專屬	专属	zhuānshǔ
處置	处置	chǔzhì
洽談	洽谈	qiàtán
國中生	国中生	guózhōngshēng
突破	突破	túpò
降至	降至	jiàngzhì
信託	信讬	xìntuō
貪污	贪污	tānwū
假使	假使	jiǎshǐ
張開	张开	zhāngkāi
單打	单打	dāndǎ
停車位	停车位	tíngchēwèi
綁	绑	bǎng
填	填	tián
貴賓	贵宾	guìbīn
葡萄	葡萄	pútáo
隔壁	隔壁	gébì
沿岸	沿岸	yánàn
光華	光华	guānghuá
傾倒	倾倒	qīngdào
混	混	hùn
束縛	束缚	shùfú
朝廷	朝廷	cháotíng
兩	两	liǎng
低落	低落	dīluò
字典	字典	zìdiǎn
如意	如意	rúyì
注目	注目	zhùmù
色調	色调	sèdiào
冷漠	冷漠	lěngmò
低落	低落	dīluò
供需	供需	gōngxū
告	告	gào
例外	例外	lìwài
作物	作物	zuòwù
洽談	洽谈	qiàtán
但願	但愿	dànyuàn
束縛	束缚	shùfú
任內	任内	rènnèi
奇異	奇异	qíyì
冷漠	冷漠	lěngmò
交互	交互	jiāohù
即已	即已	jíyǐ
典範	典范	diǎnfàn
剖析	剖析	pǒuxī
紅茶	红茶	hóngchá
剖析	剖析	pǒuxī
官兵	官兵	guānbīng
人馬	人马	rénmǎ
尼泊爾	尼泊尔	níbóěr
友誼	友谊	yǒuyí
方程式	方程式	fāngchéngshì
加重	加重	jiāzhòng
半數	半数	bànshù
中華民族	中华民族	zhōnghuámínzú
引來	引来	yǐnlái
權勢	权势	quánshì
及早	及早	jízǎo
倘若	倘若	tǎngruò
釐清	厘清	líqīng
城鄉	城乡	chéngxiāng
集	集	jí
看成	看成	kànchéng
功用	功用	gōngyòng
審慎	审慎	shěnshèn
纖維	纤维	xiānwéi
等	等	děng
感慨	感慨	gǎnkài
酸	酸	suān
雲門	云门	yúnmén
節日	节日	jiérì
廢棄物	废弃物	fèiqìwù
睡眠	睡眠	shuìmián
盡情	尽情	jìnqíng
豬肉	猪肉	zhūròu
疑惑	疑惑	yíhuò
頻譜	频谱	pínpǔ
構圖	构图	gòutú
滅	灭	miè
裝備	装备	zhuāngbèi
集會	集会	jíhuì
稍後	稍后	shāohòu
集會	集会	jíhuì
隔離	隔离	gélí
富有	富有	fùyǒu
置身	置身	zhìshēn
跟隨	跟随	gēnsuí
寒冷	寒冷	hánlěng
隔離	隔离	gélí
標記	标记	biāojì
極其	极其	jíqí
摸索	摸索	mōsuǒ
勞動力	劳动力	láodònglì
慈善	慈善	císhàn
煉鋼	炼钢	liàngāng
開朗	开朗	kāilǎng
激起	激起	jīqǐ
監獄	监狱	jiānyū
劇院	剧院	jùyuàn
摸索	摸索	mōsuǒ
誘惑	诱惑	yòuhuò
漲幅	涨幅	zhǎngfú
壽命	寿命	shòumìng
莫過於	莫过于	mòguòyū
相對的	相对的	xiāngduìde5
風光	风光	fēngguāng
長老	长老	zhǎnglǎo
河南	河南	hénán
社會學	社会学	shèhuìxué
耕耘	耕耘	gēngyún
接任	接任	jiērèn
頂尖	顶尖	dǐngjiān
副作用	副作用	fùzuòyòng
動畫	动画	dònghuà
排隊	排队	páiduì
舉動	举动	jǔdòng
口氣	口气	kǒuqì
開朗	开朗	kāilǎng
戲院	戏院	xìyuàn
耕耘	耕耘	gēngyún
現年	现年	xiànnián
推翻	推翻	tuīfān
貪	贪	tān
混凝土	混凝土	hùnníngtǔ
祝	祝	zhù
乾燥	干燥	gānzào
牽涉	牵涉	qiānshè
結局	结局	jiéjú
溪流	溪流	xīliú
港務局	港务局	gǎngwùjú
時日	时日	shírì
姐姐	姐姐	jiějiě
沮喪	沮丧	jǔsàng
員	员	yuán
招呼	招呼	zhāohū
拔	拔	bá
皮草	皮草	pícǎo
行使	行使	xíngshǐ
身高	身高	shēngāo
注射	注射	zhùshè
車票	车票	chēpiào
步調	步调	bùdiào
上演	上演	shàngyǎn
妨礙	妨碍	fángài
鬆	松	sōng
次長	次长	cìzhǎng
免疫	免疫	miǎnyì
尿液	尿液	niàoyì
委屈	委屈	wěiqū
合成	合成	héchéng
宋	宋	sòng
完備	完备	wánbèi
例行	例行	lìxíng
投保	投保	tóubǎo
奇	奇	qí
放射線	放射线	fàngshèxiàn
行使	行使	xíngshǐ
打扮	打扮	dǎbàn
以內	以内	yǐnèi
日出	日出	rìchū
回頭	回头	huítóu
力求	力求	lìqiú
日出	日出	rìchū
叫聲	叫声	jiàoshēng
了解到	了解到	liǎojiědào
中產階級	中产阶级	zhōngchǎnjiējí
考驗	考验	kǎoyàn
木柵	木栅	mùzhà
入口	入口	rùkǒu
害羞	害羞	hàixiū
大海	大海	dàhǎi
沮喪	沮丧	jǔsàng
一剎那	一刹那	yīchànuó
以至於	以至于	yǐzhìyū
一塊兒	一块儿	yīkuàiēr
議程	议程	yìchéng
鹽	盐	yán
攝氏	摄氏	shèshì
點	点	diǎn
攝影	摄影	shèyǐng
鑽石	钻石	zuànshí
抓到	抓到	zhuādào
銅	铜	tóng
大夫	大夫	dàifū
注射	注射	zhùshè
眼看	眼看	yǎnkàn
阻力	阻力	zǔlì
帝王	帝王	dìwáng
後衛	后卫	hòuwèi
抽樣	抽样	chōuyàng
花蓮縣	花莲县	huāliánxiàn
抽樣	抽样	chōuyàng
承諾	承诺	chéngnuò
封閉	封闭	fēngbì
哥	哥	gē
低價	低价	dījià
清涼	清凉	qīngliáng
阻塞	阻塞	zǔsè
拿下	拿下	náxià
國樂	国乐	guóyuè
被動	被动	bèidòng
破裂	破裂	pòliè
推崇	推崇	tuīchóng
被動	被动	bèidòng
挽回	挽回	wǎnhuí
無所謂	无所谓	wúsuǒwèi
笑聲	笑声	xiàoshēng
行動電話	行动电话	xíngdòngdiànhuà
印證	印证	yìnzhèng
伴	伴	bàn
沙發	沙发	shāfā
決不	决不	juébù
老公	老公	lǎogōng
制訂	制订	zhìdìng
合一	合一	héyī
柔軟	柔软	róuruǎn
足跡	足迹	zújī
阻塞	阻塞	zǔsè
多達	多达	duōdá
即時	即时	jíshí
杯子	杯子	bēizi5
急性	急性	jíxìng
拷貝	拷贝	kǎobèi
穿著	穿着	chuānzhuó
紀念堂	纪念堂	jìniàntáng
所有	所有	suǒyǒu
高爾夫球場	高尔夫球场	gāoěrfūqiúchǎng
低價	低价	dījià
打死	打死	dǎsǐ
動搖	动摇	dòngyáo
可貴	可贵	kěguì
民謠	民谣	mínyáo
出血	出血	chūxiě
出於	出于	chūyū
白皮書	白皮书	báipíshū
比照	比照	bǐzhào
比不上	比不上	bǐbúshàng
不能不	不能不	bùnéngbù
功力	功力	gōnglì
分割	分割	fēngē
灌溉	灌溉	guàngài
獵人	猎人	lièrén
體積	体积	tǐjī
舉手	举手	jǔshǒu
議長	议长	yìzhǎng
釋放	释放	shìfàng
講評	讲评	jiǎngpíng
翻譯	翻译	fānyì
警員	警员	jǐngyuán
不停	不停	bùtíng
殘酷	残酷	cánkù
提出來	提出来	tíchūlái
通道	通道	tōngdào
傾聽	倾听	qīngtīng
開門	开门	kāimén
源自	源自	yuánzì
傾聽	倾听	qīngtīng
裝飾	装饰	zhuāngshì
腦袋	脑袋	nǎodài
筆記	笔记	bǐjì
天花板	天花板	tiānhuābǎn
殘酷	残酷	cánkù
推崇	推崇	tuīchóng
儘快	尽快	jǐnkuài
器物	器物	qìwù
標題	标题	biāotí
樹葉	树叶	shùyè
遺物	遗物	yíwù
鋪	铺	pū
頭	头	tóu
電通所	电通所	diàntōngsuǒ
分割	分割	fēngē
微弱	微弱	wéiruò
廣州	广州	guǎngzhōu
家電	家电	jiādiàn
表揚	表扬	biǎoyáng
得罪	得罪	dézuì
專任	专任	zhuānrèn
核子	核子	hézǐ
統統	统统	tǒngtǒng
酒店	酒店	jiǔdiàn
紙張	纸张	zhǐzhāng
仿冒	仿冒	fǎngmào
清除	清除	qīngchú
長庚	长庚	chánggēng
清除	清除	qīngchú
時數	时数	shíshù
掃描	扫描	sǎomiáo
細緻	细致	xìzhì
跳水	跳水	tiàoshuǐ
登場	登场	dēngcháng
診斷	诊断	zhěnduàn
做錯	做错	zuòcuò
乖乖	乖乖	guāiguāi
收取	收取	shōuqǔ
抨擊	抨击	pēngjí
姊妹	姊妹	jiěmèi
光輝	光辉	guānghuī
灰色	灰色	huīsè
收取	收取	shōuqǔ
宛如	宛如	wǎnrú
思潮	思潮	sīcháo
命令	命令	mìnglìng
恐慌	恐慌	kǒnghuāng
忍耐	忍耐	rěnnài
坦白	坦白	tǎnbái
行銷	行销	xíngxiāo
西北	西北	xīběi
成就	成就	chéngjiù
兩廳院	两厅院	liǎngtīngyuàn
恐慌	恐慌	kǒnghuāng
放假	放假	fàngjià
堪稱	堪称	kānchēng
作畫	作画	zuòhuà
代理商	代理商	dàilǐshāng
雇用	雇用	gùyòng
壓縮	压缩	yāsuō
歌詞	歌词	gēcí
領取	领取	lǐngqǔ
打出	打出	dǎchū
考生	考生	kǎoshēng
永續	永续	yǒngxù
必修	必修	bìxiū
未婚	未婚	wèihūn
管線	管线	guǎnxiàn
手腕	手腕	shǒuwàn
嶄新	崭新	zhǎnxīn
一來	一来	yīlái
共鳴	共鸣	gòngmíng
謙虛	谦虚	qiānxū
離家	离家	líjiā
繳交	缴交	jiǎojiāo
鑰匙	钥匙	yàoshi5
籠罩	笼罩	lóngzhào
鍵入	键入	jiànrù
體諒	体谅	tǐliàng
右傾	右倾	yòuqīng
衝突	冲突	chōngtú
並列	并列	bìngliè
鈔票	钞票	chāopiào
博覽會	博览会	bólǎnhuì
登場	登场	dēngcháng
跳水	跳水	tiàoshuǐ
學年	学年	xuénián
罰	罚	fá
戲曲	戏曲	xìqǔ
機讀	机读	jīdú
鮑	鲍	bào
撐	撑	chēng
雇用	雇用	gùyòng
截止	截止	jiézhǐ
應徵	应征	yìngzhēng
摩托車	摩托车	mótuōchē
調查局	调查局	diàochájú
緩和	缓和	huǎnhé
默契	默契	mòqì
暢銷	畅销	chàngxiāo
嘆	叹	tàn
領取	领取	lǐngqǔ
享用	享用	xiǎngyòng
招標	招标	zhāobiāo
守法	守法	shǒufǎ
名譽	名誉	míngyū
巡邏	巡逻	xúnluó
自助	自助	zìzhù
扭轉	扭转	niǒuzhuǎn
合唱	合唱	héchàng
存放	存放	cúnfàng
成敗	成败	chéngbài
罕見	罕见	hǎnjiàn
星團	星团	xīngtuán
降到	降到	jiàngdào
移送法辦	移送法办	yísòngfǎbàn
威權	威权	wēiquán
交易	交易	jiāoyì
長途	长途	chángtú
革新	革新	géxīn
皇家	皇家	huángjiā
值	值	zhí
附設	附设	fùshè
招標	招标	zhāobiāo
油畫	油画	yóuhuà
沾	沾	zhān
起點	起点	qǐdiǎn
起源	起源	qǐyuán
糾正	纠正	jiūzhèng
歸納	归纳	guīnà
坐下	坐下	zuòxià
低迷	低迷	dīmí
交貨	交货	jiāohuò
制止	制止	zhìzhǐ
扭轉	扭转	niǒuzhuǎn
霧	雾	wù
變為	变为	biànwéi
轟炸	轰炸	hōngzhà
攝取	摄取	shèqǔ
寶石	宝石	bǎoshí
守法	守法	shǒufǎ
警告	警告	jǐnggào
巡邏	巡逻	xúnluó
生前	生前	shēngqián
因果	因果	yīnguǒ
存放	存放	cúnfàng
宗	宗	zōng
貝殼	贝壳	bèiké
有空	有空	yǒukòng
忠實	忠实	zhōngshí
作文	作文	zuòwén
使出	使出	shǐchū
老公公	老公公	lǎogōnggōng
革新	革新	géxīn
攝取	摄取	shèqǔ
糾正	纠正	jiūzhèng
會同	会同	huìtóng
準	准	zhǔn
提名	提名	tímíng
筆墨	笔墨	bǐmò
路程	路程	lùchéng
截至	截至	jiézhì
臺灣省	台湾省	táiwānshěng
齊	齐	qí
樁	桩	zhuāng
濕	湿	shī
演戲	演戏	yǎnxì
提名	提名	tímíng
縱使	纵使	zòngshǐ
螃蟹	螃蟹	pángxiè
演藝	演艺	yǎnyì
滿	满	mǎn
輪椅	轮椅	lúnyǐ
巧妙	巧妙	qiǎomiào
分化	分化	fēnhuà
用法	用法	yòngfǎ
北大	北大	běidà
人次	人次	réncì
分化	分化	fēnhuà
反映出	反映出	fǎnyìngchū
才華	才华	cáihuá
平埔族	平埔族	píngbǔzú
旅程	旅程	lǔchéng
悠久	悠久	yōujiǔ
野鳥	野鸟	yěniǎo
幕	幕	mù
雲林	云林	yúnlín
情懷	情怀	qínghuái
秦王	秦王	qínwáng
無非	无非	wúfēi
連	连	lián
野	野	yě
部署	部署	bùshù
偏差	偏差	piānchā
位子	位子	wèizi5
當地人	当地人	dāngdìrén
意者	意者	yìzhě
想必	想必	xiǎngbì
脆弱	脆弱	cuìruò
痣	痣	zhì
無能	无能	wúnéng
傳真	传真	chuánzhēn
無能	无能	wúnéng
萎縮	萎缩	wěisuō
喂	喂	wèi
萎縮	萎缩	wěisuō
換取	换取	huànqǔ
渡過	渡过	dùguò
帳號	帐号	zhànghào
描述	描述	miáoshù
貨品	货品	huòpǐn
消防	消防	xiāofáng
桌	桌	zhuō
混	混	hùn
帶原者	带原者	dàiyuánzhě
得來	得来	délái
貧血	贫血	pínxiě
排水	排水	páishuǐ
現存	现存	xiàncún
涼	凉	liáng
跑去	跑去	pǎoqù
淡化	淡化	dànhuà
排水	排水	páishuǐ
情操	情操	qíngcāo
評論	评论	pínglùn
愛上	爱上	àishàng
進攻	进攻	jìngōng
閒	閒	xián
腦子	脑子	nǎozi5
跨越	跨越	kuàyuè
幾何	几何	jǐhé
買下	买下	mǎixià
進攻	进攻	jìngōng
塔	塔	tǎ
承諾	承诺	chéngnuò
高溫	高温	gāowēn
塞	塞	sè
撤出	撤出	chèchū
擋	挡	dǎng
反之	反之	fǎnzhī
井	井	jǐng
氾濫	氾滥	fànlàn
上限	上限	shàngxiàn
代表團	代表团	dàibiǎotuán
氾濫	氾滥	fànlàn
外加	外加	wàijiā
付諸	付诸	fùzhū
糖尿病	糖尿病	tángniàobìng
複製	复制	fùzhì
整治	整治	zhěngzhì
複製	复制	fùzhì
餘額	余额	yūé
維繫	维系	wéixì
優越	优越	yōuyuè
卡車	卡车	kǎchē
容忍	容忍	róngrěn
屬性	属性	shǔxìng
驚奇	惊奇	jīngqí
彎曲	弯曲	wānqū
翻開	翻开	fānkāi
擷取	撷取	jiéqǔ
點燃	点燃	diǎnrán
市議會	市议会	shìyìhuì
生活圈	生活圈	shēnghuóquān
維繫	维系	wéixì
出巡	出巡	chūxún
拒	拒	jù
包容	包容	bāoróng
大事	大事	dàshì
甘心	甘心	gānxīn
山頭	山头	shāntóu
牙	牙	yá
故障	故障	gùzhàng
物種	物种	wùzhǒng
容忍	容忍	róngrěn
屏東縣	屏东县	píngdōngxiàn
派出	派出	pàichū
重整	重整	chóngzhěng
環繞	环绕	huánrào
看似	看似	kànsì
月餅	月饼	yuèbǐng
河水	河水	héshuǐ
耐	耐	nài
抱負	抱负	bàofù
外科	外科	wàikē
哎喲	哎哟	āiyāo
美觀	美观	měiguān
拼命	拼命	pīnmìng
侷限	侷限	júxiàn
姓	姓	xìng
故障	故障	gùzhàng
福祉	福祉	fúzhǐ
兇	兇	xiōng
安寧	安宁	ānníng
列出	列出	lièchū
姓	姓	xìng
安全性	安全性	ānquánxìng
屁股	屁股	pìgǔ
安寧	安宁	ānníng
死去	死去	sǐqù
走私	走私	zǒusī
坊間	坊间	fāngjiān
走私	走私	zǒusī
抉擇	抉择	juézé
利多	利多	lìduō
自來水	自来水	zìláishuǐ
保送	保送	bǎosòng
皇后	皇后	huánghòu
息息相關	息息相关	xíxíxiāngguān
蔓延	蔓延	mànyán
格	格	gé
梅	梅	méi
發放	发放	fāfàng
配偶	配偶	pèiǒu
填寫	填写	tiánxiě
區運	区运	qūyùn
陸委會	陆委会	lùwěihuì
頂	顶	dǐng
消耗	消耗	xiāohào
現已	现已	xiànyǐ
接待	接待	jiēdài
淡大	淡大	dàndà
統合	统合	tǒnghé
填寫	填写	tiánxiě
族人	族人	zúrén
統合	统合	tǒnghé
寒	寒	hán
遊玩	遊玩	yóuwán
喚起	唤起	huànqǐ
買進	买进	mǎijìn
純粹	纯粹	chúncuì
財力	财力	cáilì
缺陷	缺陷	quēxiàn
終生	终生	zhōngshēng
做飯	做饭	zuòfàn
頂	顶	dǐng
有益	有益	yǒuyì
海運	海运	hǎiyùn
安徽	安徽	ānhuī
威尼斯	威尼斯	wēinísī
流水	流水	liúshuǐ
借用	借用	jièyòng
修理	修理	xiūlǐ
污水	污水	wūshuǐ
西方人	西方人	xīfāngrén
在座	在座	zàizuò
折	折	zhé
言行	言行	yánxíng
佳績	佳绩	jiājī
多采多姿	多采多姿	duōcǎiduōzī
有事	有事	yǒushì
修理	修理	xiūlǐ
用到	用到	yòngdào
走去	走去	zǒuqù
大溪	大溪	dàxī
代為	代为	dàiwéi
加盟	加盟	jiāméng
凸顯	凸显	túxiǎn
上場	上场	shàngchǎng
加盟	加盟	jiāméng
白人	白人	báirén
獎章	奖章	jiǎngzhāng
用餐	用餐	yòngcān
機密	机密	jīmì
一大早	一大早	yīdàzǎo
不得已	不得已	bùdéyǐ
本性	本性	běnxìng
大專院校	大专院校	dàzhuānyuànxiào
史語所	史语所	shǐyǔsuǒ
黨員	党员	dǎngyuán
點點	点点	diǎndiǎn
人手	人手	rénshǒu
總體	总体	zǒngtǐ
認	认	rèn
操	操	cāo
關係	关系	guānxì
甄選	甄选	zhēnxuǎn
蔓延	蔓延	mànyán
奪得	夺得	duódé
云	云	yún
遠東	远东	yuǎndōng
調高	调高	tiáogāo
隨地	随地	suídì
弊端	弊端	bìduān
積分	积分	jīfēn
課堂	课堂	kètáng
蒙古	蒙古	ménggǔ
摘	摘	zhé
歐洲人	欧洲人	ōuzhōurén
燈具	灯具	dēngjù
調高	调高	tiáogāo
勞保	劳保	láobǎo
買進	买进	mǎijìn
意識到	意识到	yìshìdào
渴望	渴望	kěwàng
麥克風	麦克风	màikèfēng
發放	发放	fāfàng
節點	节点	jiédiǎn
違建	违建	wéijiàn
農田	农田	nóngtián
遊覽車	遊览车	yóulǎnchē
接待	接待	jiēdài
軸	轴	zhóu
標竿	标竿	biāogān
載入	载入	zàirù
要緊	要紧	yàojǐn
訂購	订购	dìnggòu
前方	前方	qiánfāng
軍官	军官	jūnguān
烈	烈	liè
保送	保送	bǎosòng
美妙	美妙	měimiào
哈佛	哈佛	hāfó
東區	东区	dōngqū
保費	保费	bǎofèi
近代史	近代史	jìndàishǐ
相通	相通	xiāngtōng
怨	怨	yuàn
相對於	相对于	xiāngduìyú
恰好	恰好	qiàhǎo
乘坐	乘坐	chéngzuò
受損	受损	shòusǔn
祈求	祈求	qíqiú
立	立	lì
佛法	佛法	fófǎ
弦	弦	xián
汗	汗	hàn
作成	作成	zuòchéng
法治	法治	fǎzhì
成年	成年	chéngnián
非凡	非凡	fēifán
白雪	白雪	báixuě
肺	肺	fèi
官司	官司	guānsī
樹幹	树干	shùgàn
拜託	拜托	bàituō
比對	比对	bǐduì
山東	山东	shāndōng
加值	加值	jiāzhí
水分	水分	shuǐfèn
左邊	左边	zuǒbiān
史前	史前	shǐqián
台中縣	台中县	táizhōngxiàn
敲	敲	qiāo
水土	水土	shuǐtǔ
幕僚	幕僚	mùliáo
鞏固	巩固	gǒnggù
演習	演习	yǎnxí
福特	福特	fútè
演習	演习	yǎnxí
調	调	tiáo
鞏固	巩固	gǒnggù
賠	赔	péi
出動	出动	chūdòng
覆蓋	覆盖	fùgài
點心	点心	diǎnxīn
舉凡	举凡	jǔfán
響應	响应	xiǎngyìng
聯誼	联谊	liányí
職責	职责	zhízé
謊言	谎言	huǎngyán
人類學	人类学	rénlèixué
手足	手足	shǒuzú
會報	会报	huìbào
主講	主讲	zhǔjiǎng
刀子	刀子	dāozi5
北平	北平	běipíng
古物	古物	gǔwù
天使	天使	tiānshǐ
大哥大	大哥大	dàgēdà
比對	比对	bǐduì
四肢	四肢	sìzhī
情意	情意	qíngyì
液晶	液晶	yìjīng
陪伴	陪伴	péibàn
陳述	陈述	chénshù
莫不	莫不	mòbù
陸軍	陆军	lùjūn
聲稱	声称	shēngchēng
追趕	追赶	zhuīgǎn
教化	教化	jiàohuà
細則	细则	xìzé
累計	累计	lěijì
處	处	chǔ
累計	累计	lěijì
動植物	动植物	dòngzhíwù
長年	长年	chángnián
封閉	封闭	fēngbì
桶	桶	tǒng
透視	透视	tòushì
急	急	jí
賊	贼	zéi
毀滅	毁灭	huǐmiè
殘障者	残障者	cánzhàngzhě
詩歌	诗歌	shīgē
落成	落成	luòchéng
幾	几	jī
貧困	贫困	pínkùn
募款	募款	mùkuǎn
透視	透视	tòushì
停下來	停下来	tíngxiàlái
晚飯	晚饭	wǎnfàn
祕密	祕密	mìmì
貧困	贫困	pínkùn
記住	记住	jìzhù
剪	剪	jiǎn
教化	教化	jiàohuà
飲茶	饮茶	yǐnchá
落成	落成	luòchéng
李遠哲	李远哲	lǐyuǎnzhé
活生生	活生生	huóshēngshēng
國軍	国军	guójūn
青菜	青菜	qīngcài
幽浮	幽浮	yōufú
虐待	虐待	nuèdài
准	准	zhǔn
為數	为数	wéishù
面對面	面对面	miànduìmiàn
組	组	zǔ
細部	细部	xìbù
堂哥	堂哥	tánggē
素養	素养	sùyǎng
掃	扫	sǎo
理事	理事	lǐshì
放入	放入	fàngrù
高漲	高涨	gāozhǎng
商務	商务	shāngwù
高漲	高涨	gāozhǎng
能幹	能干	nénggàn
核能	核能	hénéng
造訪	造访	zàofǎng
通	通	tōng
淚水	泪水	lèishuǐ
教育部長	教育部长	jiàoyūbùzhǎng
時而	时而	shíér
造訪	造访	zàofǎng
雪梨	雪梨	xuělí
快要	快要	kuàiyào
合理化	合理化	hélǐhuà
佔領	佔领	zhànlǐng
汽機車	汽机车	qìjīchē
批准	批准	pīzhǔn
刺激	刺激	cìjī
西德	西德	xīdé
份量	份量	fènliàng
合同	合同	hétong
似	似	sì
村莊	村庄	cūnzhuāng
那裡	那里	nàlǐ
洞穴	洞穴	dòngxuè
老化	老化	lǎohuà
風光	风光	fēngguāng
走過去	走过去	zǒuguòqù
伸	伸	shēn
老化	老化	lǎohuà
免於	免于	miǎnyū
房租	房租	fángzū
阿美族	阿美族	āměizú
糾纏	纠缠	jiūchán
放出	放出	fàngchū
風箏	风筝	fēngzhēng
放映	放映	fàngyìng
風光	风光	fēngguāng
電	电	diàn
改用	改用	gǎiyòng
方位	方位	fāngwèi
頭銜	头衔	tóuxián
碼	码	mǎ
整	整	zhěng
踏上	踏上	tàshàng
憧憬	憧憬	chōngjǐng
總務	总务	zǒngwù
憧憬	憧憬	chōngjǐng
臺北縣	台北县	táiběixiàn
撞	撞	zhuàng
認清	认清	rènqīng
出爐	出炉	chūlú
期許	期许	qíxǔ
子彈	子弹	zǐdàn
嘗試	尝试	chángshì
回流	回流	huíliú
大肆	大肆	dàsì
公演	公演	gōngyǎn
不慎	不慎	búshèn
外長	外长	wàizhǎng
水電	水电	shuǐdiàn
心臟病	心脏病	xīnzàngbìng
公演	公演	gōngyǎn
巴格達	巴格达	bāgédá
小販	小贩	xiǎofàn
公認	公认	gōngrèn
瀑布	瀑布	pùbù
女郎	女郎	nǔláng
意涵	意涵	yìhán
合理化	合理化	hélǐhuà
須要	须要	xūyào
復興	复兴	fùxīng
期許	期许	qíxǔ
禁	禁	jìn
遇見	遇见	yūjiàn
解說	解说	jiěshuō
照射	照射	zhàoshè
景物	景物	jǐngwù
量	量	liáng
發洩	发泄	fāxiè
銜接	衔接	xiánjiē
幹員	干员	gànyuán
銜接	衔接	xiánjiē
照射	照射	zhàoshè
順	顺	shùn
開闊	开阔	kāikuò
質詢	质询	zhíxún
熱絡	热络	rèluò
選取	选取	xuǎnqǔ
熱絡	热络	rèluò
質詢	质询	zhíxún
圖畫	图画	túhuà
盤旋	盘旋	pánxuán
餘地	余地	yūdì
魚塭	鱼塭	yūwēn
感恩	感恩	gǎnēn
雞蛋	鸡蛋	jīdàn
攤位	摊位	tānwèi
嚼	嚼	jué
驚喜	惊喜	jīngxǐ
雜貨店	杂货店	záhuòdiàn
批准	批准	pīzhǔn
法律系	法律系	fǎlùxì
鍵盤	键盘	jiànpán
偶而	偶而	ǒuér
虔誠	虔诚	qiánchéng
偶然	偶然	ǒurán
脈絡	脉络	mòluò
耗費	耗费	hàofèi
抗原	抗原	kàngyuán
耗費	耗费	hàofèi
效用	效用	xiàoyòng
婚禮	婚礼	hūnlǐ
起	起	qǐ
時髦	时髦	shímáo
情調	情调	qíngdiào
係數	系数	xìshù
這裏	这里	zhèlǐ
拍賣	拍卖	pāimài
虔誠	虔诚	qiánchéng
盛況	盛况	shèngkuàng
混淆	混淆	hǔnyáo
國手	国手	guóshǒu
窄	窄	zhǎi
神仙	神仙	shénxiān
時效	时效	shíxiào
頂多	顶多	dǐngduō
連鎖	连锁	liánsuǒ
疼	疼	téng
依循	依循	yīxún
任用	任用	rènyòng
沉重	沉重	chénzhòng
來不及	来不及	láibùjí
字眼	字眼	zìyǎn
作曲家	作曲家	zuòqǔjiā
自強	自强	zìqiáng
任用	任用	rènyòng
盯	盯	dīng
前輩	前辈	qiánbèi
疫苗	疫苗	yìmiáo
疲倦	疲倦	píjuàn
巷	巷	xiàng
服	服	fú
政客	政客	zhèngkè
版權	版权	bǎnquán
服氣	服气	fúqì
服藥	服药	fúyào
爭奪	争夺	zhēngduó
病例	病例	bìnglì
信件	信件	xìnjiàn
拍賣	拍卖	pāimài
票價	票价	piàojià
長短	长短	chángduǎn
座位	座位	zuòwèi
上去	上去	shàngqù
預先	预先	yūxiān
實話	实话	shíhuà
縣委	县委	xiànwěi
北區	北区	běiqū
母	母	mǔ
而今	而今	érjīn
互	互	hù
下挫	下挫	xiàcuò
山頂	山顶	shāndǐng
未知	未知	wèizhī
打到	打到	dǎdào
淹沒	淹没	yānmò
地層	地层	dìcéng
謀生	谋生	móushēng
一手	一手	yīshǒu
中斷	中断	zhōngduàn
餵	餵	wèi
懲罰	惩罚	chéngfá
講解	讲解	jiǎngjiě
聽取	听取	tīngqǔ
蘇格蘭	苏格兰	sūgélán
礦工	矿工	kuànggōng
籌措	筹措	chóucuò
舉起	举起	jǔqǐ
檳榔	槟榔	bīnláng
下挫	下挫	xiàcuò
畫廊	画廊	huàláng
貨車	货车	huòchē
酗酒	酗酒	xùjiǔ
無常	无常	wúcháng
發揚	发扬	fāyáng
煩	烦	fán
感人	感人	gǎnrén
發揚	发扬	fāyáng
策劃	策划	cèhuà
遇上	遇上	yūshàng
殖民地	殖民地	zhímíndì
順	顺	shùn
墾丁	垦丁	kěndīng
路段	路段	lùduàn
館長	馆长	guǎnzhǎng
童工	童工	tónggōng
嗜好	嗜好	shìhào
親愛	亲爱	qīnài
營利	营利	yínglì
論點	论点	lùndiǎn
獲取	获取	huòqǔ
編號	编号	biānhào
獨裁	独裁	dúcái
歷史系	历史系	lìshǐxì
雌	雌	cí
臺南	台南	táinán
混淆	混淆	hǔnyáo
著想	着想	zháoxiǎng
依循	依循	yīxún
祕書	祕书	mìshū
送往	送往	sòngwǎng
傑作	杰作	jiézuò
紛爭	纷争	fēnzhēng
途	途	tú
參選	参选	cānxuǎn
食用	食用	shíyòng
張貼	张贴	zhāngtiē
得失	得失	déshī
抽籤	抽籤	chōuqiān
剝削	剥削	bōxuè
服從	服从	fúcóng
風行	风行	fēngxíng
到時候	到时候	dàoshíhòu
張	张	zhāng
現成	现成	xiànchéng
損壞	损坏	sǔnhuài
農夫	农夫	nóngfū
農藥	农药	nóngyào
登陸	登陆	dēnglù
剩餘	剩余	shèngyū
假設	假设	jiǎshè
陣容	阵容	zhènróng
最多	最多	zuìduō
張貼	张贴	zhāngtiē
參選	参选	cānxuǎn
健行	健行	jiànxíng
莫名其妙	莫名其妙	mòmíngqímiào
侮辱	侮辱	wǔrù
郵政	邮政	yóuzhèng
投降	投降	tóuxiáng
風行	风行	fēngxíng
振動	振动	zhèndòng
剝削	剥削	bōxuè
肥	肥	féi
約談	约谈	yuētán
苦難	苦难	kǔnàn
投降	投降	tóuxiáng
省思	省思	xǐngsī
吃掉	吃掉	chīdiào
沈默	沈默	chénmò
交流道	交流道	jiāoliúdào
好事	好事	hǎoshì
波蘭	波兰	pōlán
因緣	因缘	yīnyuán
吸血鬼	吸血鬼	xīxiěguǐ
初中	初中	chūzhōng
為由	为由	wéiyóu
烈酒	烈酒	lièjiǔ
約談	约谈	yuētán
沼澤	沼泽	zhǎozé
計算機	计算机	jìsuànjī
省思	省思	xǐngsī
抽籤	抽籤	chōuqiān
揮	挥	huī
陌生人	陌生人	mòshēngrén
香檳	香槟	xiāngbīn
服從	服从	fúcóng
枕頭	枕头	zhěntou
飛翔	飞翔	fēixiáng
侮辱	侮辱	wǔrù
首相	首相	shǒuxiàng
分擔	分担	fēndān
反觀	反观	fǎnguān
功利	功利	gōnglì
分	分	fēn
人世	人世	rénshì
巨	巨	jù
考核	考核	kǎohé
本領	本领	běnlǐng
生育	生育	shēngyū
天命	天命	tiānmìng
田園	田园	tiányuán
公務	公务	gōngwù
分擔	分担	fēndān
公債	公债	gōngzhài
損壞	损坏	sǔnhuài
月球	月球	yuèqiú
太陽能	太阳能	tàiyángnéng
縮減	缩减	suōjiǎn
鍵	键	jiàn
覺	觉	jiào
鎮壓	镇压	zhènyā
灌輸	灌输	guànshū
大規模	大规模	dàguīmó
大街	大街	dàjiē
共產	共产	gòngchǎn
回教	回教	huíjiào
心智	心智	xīnzhì
下手	下手	xiàshǒu
大夥	大伙	dàhuǒ
出海	出海	chūhǎi
打斷	打断	dǎduàn
大大小小	大大小小	dàdàxiǎoxiǎo
登陸	登陆	dēnglù
天色	天色	tiānsè
滴	滴	dī
歌壇	歌坛	gētán
頑皮	顽皮	wánpí
歌舞	歌舞	gēwǔ
綿延	绵延	miányán
適宜	适宜	shìyí
精進	精进	jīngjìn
節慶	节庆	jiéqìng
喜好	喜好	xǐhào
悶	闷	mēn
搜集	搜集	sōují
湖南	湖南	húnán
喜好	喜好	xǐhào
頑皮	顽皮	wánpí
撿	捡	jiǎn
切入	切入	qiērù
民選	民选	mínxuǎn
人行道	人行道	rénxíngdào
生育	生育	shēngyū
戰士	战士	zhànshì
樂於	乐于	lèyú
濕地	湿地	shīdì
視線	视线	shìxiàn
製作人	制作人	zhìzuórén
營地	营地	yíngdì
糊塗	糊涂	hútú
慕尼黑	慕尼黑	mùníhēi
賣出	卖出	màichū
閩南語	闽南语	mǐnnányǔ
存活	存活	cúnhuó
博物院	博物院	bówùyuàn
沈默	沈默	chénmò
孤立	孤立	gūlì
奉	奉	fèng
交錯	交错	jiāocuò
刻板	刻板	kèbǎn
征服	征服	zhēngfú
受益	受益	shòuyì
車行	车行	chēháng
合辦	合办	hébàn
光緒	光绪	guāngxù
成形	成形	chéngxíng
多方	多方	duōfāng
每隔	每隔	měigé
羽球	羽球	yǔqiú
孤立	孤立	gūlì
存活	存活	cúnhuó
強壯	强壮	qiángzhuàng
悠閒	悠閒	yōuxián
追問	追问	zhuīwèn
通往	通往	tōngwǎng
密碼	密码	mìmǎ
前所未有	前所未有	qiánsuǒwèiyǒu
為首	为首	wéishǒu
眉	眉	méi
強制	强制	qiángzhì
匯集	汇集	huìjí
看病	看病	kànbìng
國文	国文	guówén
笛子	笛子	dízi5
執法	执法	zhífǎ
處理器	处理器	chǔlǐqì
蚊	蚊	wén
堆積	堆积	duījī
許許多多	许许多多	xǔxǔduōduō
侵入	侵入	qīnrù
商用	商用	shāngyòng
原油	原油	yuányóu
註明	注明	zhùmíng
悲傷	悲伤	bēishāng
堆積	堆积	duījī
性命	性命	xìngmìng
自此	自此	zìcǐ
串	串	chuàn
估算	估算	gūsuàn
立志	立志	lìzhì
育樂	育乐	yūlè
安全感	安全感	ānquángǎn
吃力	吃力	chīlì
西南	西南	xīnán
呵	呵	hē
村落	村落	cūnluò
佣金	佣金	yōngjīn
肥料	肥料	féiliào
重現	重现	chóngxiàn
保全	保全	bǎoquán
爭相	争相	zhēngxiāng
原告	原告	yuángào
跟進	跟进	gēnjìn
芭蕾	芭蕾	bālěi
跟進	跟进	gēnjìn
保全	保全	bǎoquán
重覆	重复	chóngfù
砂石	砂石	shāshí
直線	直线	zhíxiàn
重現	重现	chóngxiàn
根據	根据	gēnjù
侵入	侵入	qīnrù
研習會	研习会	yánxíhuì
上前	上前	shàngqián
不准	不准	bùzhǔn
中鋒	中锋	zhōngfēng
市議員	市议员	shìyìyuán
包圍	包围	bāowéi
甘肅	甘肃	gānsù
木頭	木头	mùtóu
大三	大三	dàsān
下水道	下水道	xiàshuǐdào
奴隸	奴隶	núlì
不忘	不忘	búwàng
充當	充当	chōngdāng
僑生	侨生	shēng
右邊	右边	yòubiān
屢	屡	lǔ
未免	未免	wèimiǎn
大理石	大理石	dàlǐshí
人質	人质	rénzhí
回饋	回馈	huíkuì
打聽	打听	dǎtīng
人影	人影	rényǐng
丈	丈	zhàng
包圍	包围	bāowéi
山洞	山洞	shāndòng
護	护	hù
鴿子	鸽子	gēzi5
蹤跡	踪迹	zōngjī
全國性	全国性	quánguóxìng
單調	单调	dāndiào
微妙	微妙	wéimiào
悲傷	悲伤	bēishāng
圍繞	围绕	wéirào
景致	景致	jǐngzhì
匯集	汇集	huìjí
來往	来往	láiwǎng
絲	丝	sī
自信心	自信心	zìxìnxīn
新奇	新奇	xīnqí
無用	无用	wúyòng
過境	过境	guòjìng
飽受	饱受	bǎoshòu
網絡	网络	wǎngluò
著稱	著称	zhùchēng
寫照	写照	xiězhào
惡	恶	è
督促	督促	dūcù
感嘆	感叹	gǎntàn
源頭	源头	yuántóu
壺	壶	hú
暫	暂	zhàn
標示	标示	biāoshì
錢	钱	qián
零組件	零组件	língzǔjiàn
盡頭	尽头	jìntóu
語言學	语言学	yǔyánxué
普渡	普渡	pǔdù
督促	督促	dūcù
好奇心	好奇心	hàoqíxīn
來自於	来自于	láizìyū
走動	走动	zǒudòng
諒解	谅解	liàngjiě
飲	饮	yǐn
天皇	天皇	tiānhuáng
儘	尽	jǐn
蒙	蒙	méng
辣	辣	là
慚愧	惭愧	cánkuì
榕樹	榕树	róngshù
模組	模组	mózǔ
山丘	山丘	shānqiū
團圓	团圆	tuányuán
代表會	代表会	dàibiǎohuì
燃料	燃料	ránliào
歌仔戲	歌仔戏	gēzǎixì
憲政	宪政	xiànzhèng
夢幻	梦幻	mènghuàn
滑水	滑水	huáshuǐ
結盟	结盟	jiéméng
舅舅	舅舅	jiùjiù
圓形	圆形	yuánxíng
諒解	谅解	liàngjiě
欠	欠	qiàn
倡導	倡导	chàngdǎo
繩子	绳子	shéngzi5
覺悟	觉悟	juéwù
讚賞	赞赏	zànshǎng
額度	额度	édù
藝品	艺品	yìpǐn
分泌	分泌	fēnmì
上方	上方	shàngfāng
王朝	王朝	wángcháo
北上	北上	běishàng
不自覺	不自觉	búzìjué
由來	由来	yóulái
主計處	主计处	zhǔjìchù
日夜	日夜	rìyè
不盡	不尽	bújìn
分泌	分泌	fēnmì
只不過	只不过	zhǐbúguò
外圍	外围	wàiwéi
少爺	少爷	shàoyé
北上	北上	běishàng
美滿	美满	měimǎn
偏好	偏好	piānhào
清澈	清澈	qīngchè
送來	送来	sònglái
船長	船长	chuánzhǎng
晚年	晚年	wǎnnián
書局	书局	shūjú
曹操	曹操	cáocāo
偏好	偏好	piānhào
偽造	伪造	wěizào
海灣	海湾	hǎiwān
倉儲	仓储	cāngchú
音樂家	音乐家	yīnyuèjiā
信息	信息	xìnxí
知情	知情	zhīqíng
庫存	库存	kùcún
振興	振兴	zhènxīng
捏	捏	niē
超出	超出	chāochū
中立	中立	zhōnglì
南管	南管	nánguǎn
結盟	结盟	jiéméng
勝過	胜过	shèngguò
感冒	感冒	gǎnmào
振興	振兴	zhènxīng
盛會	盛会	shènghuì
塞納河	塞纳河	sènàhé
飽	饱	bǎo
飾演	饰演	shìyǎn
奧林匹克	奥林匹克	àolínpīkè
準時	准时	zhǔnshí
過渡	过渡	guòdù
造勢	造势	zàoshì
著實	着实	zhuóshí
清洗	清洗	qīngxǐ
笙	笙	shēng
清洗	清洗	qīngxǐ
將要	将要	jiāngyào
偽造	伪造	wěizào
排定	排定	páidìng
追究	追究	zhuījiù
華文	华文	huáwén
呼應	呼应	hūyìng
赤字	赤字	chìzì
年級	年级	niánjí
到場	到场	dàochǎng
自家	自家	zìjiā
向善	向善	xiàngshàn
西裝	西装	xīzhuāng
多加	多加	duōjiā
受難	受难	shòunàn
洪水	洪水	hóngshuǐ
技法	技法	jìfǎ
多寡	多寡	duōguǎ
形勢	形势	xíngshì
京都	京都	jīngdū
呼應	呼应	hūyìng
防守	防守	fángshǒu
江	江	jiāng
些許	些许	xiēxǔ
竹林	竹林	zhúlín
防守	防守	fángshǒu
法務部	法务部	fǎwùbù
步伐	步伐	bùfá
經理人	经理人	jīnglǐrén
發脾氣	发脾气	fāpíqì
想出	想出	xiǎngchū
喘	喘	chuǎn
端	端	duān
腎	肾	shèn
照樣	照样	zhàoyàng
麻痺	麻痺	mábì
漲停	涨停	zhǎngtíng
傳真	传真	chuánzhēn
歷時	历时	lìshí
筷子	筷子	kuàizi5
做愛	做爱	zuòài
預訂	预订	yūdìng
銅像	铜像	tóngxiàng
趕上	赶上	gǎnshàng
報章	报章	bàozhāng
連忙	连忙	liánmáng
救援	救援	jiùyuán
粗糙	粗糙	cūcào
大腦	大脑	dànǎo
機票	机票	jīpiào
接送	接送	jiēsòng
添加	添加	tiānjiā
酒吧	酒吧	jiǔbā
處分	处分	chǔfèn
惡鬼	恶鬼	èguǐ
純樸	纯朴	chúnpú
做愛	做爱	zuòài
票房	票房	piàofáng
時程	时程	shíchéng
盛大	盛大	shèngdà
添加	添加	tiānjiā
單價	单价	dānjià
送醫	送医	sùyī
內戰	内战	nèizhàn
功勞	功劳	gōngláo
出擊	出击	chūjí
大軍	大军	dàjūn
外海	外海	wàihǎi
介於	介于	jièyū
位址	位址	wèizhǐ
出擊	出击	chūjí
天文學	天文学	tiānwénxué
工商業	工商业	gōngshāngyè
舉止	举止	jǔzhǐ
瀰漫	瀰漫	mímàn
攝	摄	shè
禮儀	礼仪	lǐyí
強硬	强硬	qiángyìng
高出	高出	gāochū
打獵	打猎	dǎliè
總工會	总工会	zǒnggōnghuì
審美	审美	shěnměi
噢	噢	òu
箭	箭	jiàn
像	像	xiàng
精靈	精灵	jīnglíng
幕後	幕后	mùhòu
小徑	小径	xiǎojìng
廣闊	广阔	guǎngkuò
午後	午后	wǔhòu
截然不同	截然不同	jiéránbùtóng
賣壓	卖压	màiyā
不予	不予	bùyǔ
打入	打入	dǎrù
支票	支票	zhīpiào
一般性	一般性	yībānxìng
據悉	据悉	jùxī
樂意	乐意	lèyì
辛勤	辛勤	xīnqín
甚為	甚为	shènwéi
事業部	事业部	shìyèbù
抄襲	抄袭	chāoxí
孤單	孤单	gūdān
尖峰	尖峰	jiānfēng
列	列	liè
沉默	沉默	chénmò
抑或	抑或	yìhuò
立足	立足	lìzú
辛勤	辛勤	xīnqín
沉默	沉默	chénmò
直覺	直觉	zhíjué
空虛	空虚	kōngxū
重慶	重庆	chóngqìng
空虛	空虚	kōngxū
封鎖	封锁	fēngsuǒ
名次	名次	míngcì
有利於	有利于	yǒulìyū
往返	往返	wǎngfǎn
江南	江南	jiāngnán
注視	注视	zhùshì
淨化	淨化	jìnghuà
江湖	江湖	jiānghú
沒落	没落	mòluò
伊朗	伊朗	yīlǎng
成語	成语	chéngyǔ
抄襲	抄袭	chāoxí
企管	企管	qìguǎn
往返	往返	wǎngfǎn
身後	身后	shēnhòu
沒落	没落	mòluò
攸關	攸关	yōuguān
伙伴	伙伴	huǒbàn
豈不	岂不	qǐbù
粗糙	粗糙	cūcào
飛毛腿	飞毛腿	fēimáotuǐ
初次	初次	chūcì
砍伐	砍伐	kǎnfā
消	消	xiāo
祭拜	祭拜	jìbài
陶藝	陶艺	táoyì
流域	流域	liúyū
純樸	纯朴	chúnpú
配上	配上	pèishàng
淨化	淨化	jìnghuà
救援	救援	jiùyuán
浪	浪	làng
寂靜	寂静	jíjìng
青蛙	青蛙	qīngwā
吸取	吸取	xīqǔ
起身	起身	qǐshēn
治好	治好	zhìhǎo
星座	星座	xīngzuò
猛	猛	měng
俟	俟	sì
狩獵	狩猎	shòuliè
板塊	板块	bǎnkuài
封鎖	封锁	fēngsuǒ
砍伐	砍伐	kǎnfā
飛行員	飞行员	fēixíngyuán
花卉	花卉	huāhuì
家門	家门	jiāmén
抱歉	抱歉	bàoqiàn
迫害	迫害	pòhài
南洋	南洋	nányáng
便捷	便捷	biànjié
迫害	迫害	pòhài
便捷	便捷	biànjié
補救	补救	bǔjiù
發包	发包	fābāo
過分	过分	guòfèn
經過	经过	jīngguò
農人	农人	nóngrén
塗	涂	tú
漢語	汉语	hànyǔ
豬公	猪公	zhūgōng
聚落	聚落	jùluò
漫畫家	漫画家	mánhuàjiā
演練	演练	yǎnliàn
稀少	稀少	xīshǎo
審理	审理	shěnlǐ
漢字	汉字	hànzì
審理	审理	shěnlǐ
隔	隔	gé
揚言	扬言	yángyán
農家	农家	nóngjiā
補救	补救	bǔjiù
結晶	结晶	jiéjīng
補償	补偿	bǔcháng
發包	发包	fābāo
氣憤	气愤	qìfèn
挨	挨	āi
強暴	强暴	qiángbào
認可	认可	rènkě
樣本	样本	yàngběn
氣憤	气愤	qìfèn
強暴	强暴	qiángbào
無辜	无辜	wúgū
機型	机型	jīxíng
浮動	浮动	fúdòng
挨	挨	āi
反攻	反攻	fǎngōng
一舉	一举	yījǔ
公然	公然	gōngrán
大二	大二	dàèr
不由得	不由得	bùyóude5
去除	去除	qùchú
人氣	人气	rénqì
天主教	天主教	tiānzhǔjiào
心疼	心疼	xīnténg
口腔	口腔	kǒuqiāng
認得	认得	rèndé
擬訂	拟订	nǐdìng
精	精	jīng
認可	认可	rènkě
誤以為	误以为	wùyǐwéi
鞋	鞋	xié
稿	稿	gǎo
蒸汽	蒸汽	zhēngqì
篩選	筛选	shāixuǎn
墓	墓	mù
諾貝爾	诺贝尔	nuòbèiěr
精神科	精神科	jīngshénkē
慶典	庆典	qìngdiǎn
導覽	导览	dǎolǎn
管理處	管理处	guǎnlǐchù
課長	课长	kèzhǎng
市公所	市公所	shìgōngsuǒ
命名	命名	mìngmíng
侵蝕	侵蚀	qīnshí
花草	花草	huācǎo
東北	东北	dōngběi
浮動	浮动	fúdòng
派遣	派遣	pàiqiǎn
拉開	拉开	lākāi
法定	法定	fǎdìng
交涉	交涉	jiāoshè
吃驚	吃惊	chījīng
有害	有害	yǒuhài
呆	呆	dāi
吾人	吾人	wúrén
計	计	jì
命名	命名	mìngmíng
自然而然	自然而然	zìránérrán
定時	定时	dìngshí
每每	每每	měiměi
回味	回味	huíwèi
呈現出	呈现出	chéngxiànchū
收盤	收盘	shōupán
年少	年少	niánshào
快門	快门	kuàimén
妥當	妥当	tuǒdàng
忍心	忍心	rěnxīn
判定	判定	pàndìng
政治家	政治家	zhèngzhìjiā
氣流	气流	qìliú
交涉	交涉	jiāoshè
救濟	救济	jiùjì
判定	判定	pàndìng
香港人	香港人	xiānggǎngrén
陸地	陆地	lùdì
租金	租金	zūjīn
最終	最终	zuìzhōng
救濟	救济	jiùjì
接手	接手	jiēshǒu
陶器	陶器	táoqì
紳士	绅士	shēnshì
殺手	杀手	shāshǒu
深信	深信	shēnxìn
神色	神色	shénsè
宣揚	宣扬	xuānyáng
夏	夏	xià
炸彈	炸弹	zhàdàn
所及	所及	suǒjí
放眼	放眼	fàngyǎn
建設局	建设局	jiànshèjú
炸	炸	zhà
明瞭	明瞭	míngliǎo
青睞	青睐	qīnglài
紅包	红包	hóngbāo
車程	车程	chēchéng
席	席	xí
郊遊	郊遊	jiāoyóu
侵蝕	侵蚀	qīnshí
郊遊	郊遊	jiāoyóu
出口	出口	chūkǒu
元帥	元帅	yuánshuài
外語	外语	wàiyǔ
大勢	大势	dàshì
升等	升等	shēngděng
工商	工商	gōngshāng
上空	上空	shàngkōng
久久	久久	jiǔjiǔ
不復	不复	búfù
禮貌	礼貌	lǐmào
讀取	读取	dúqǔ
穩定性	稳定性	wěndìngxìng
工學院	工学院	gōngxuéyuàn
生物學	生物学	shēngwùxué
大使	大使	dàshǐ
出獄	出狱	chūyū
用意	用意	yòngyì
北醫	北医	běiyī
內湖	内湖	nèihú
二來	二来	èrlái
口水	口水	kǒushuǐ
顛覆	颠覆	diānfù
敘述	叙述	xùshù
專人	专人	zhuānrén
閉	闭	bì
排放	排放	páifàng
馬達	马达	mǎdá
氣味	气味	qìwèi
效力	效力	xiàolì
高爾夫球	高尔夫球	gāoěrfūqiú
終點	终点	zhōngdiǎn
教職員	教职员	jiàozhíyuán
桌椅	桌椅	zhuōyǐ
除去	除去	chúqù
捲入	卷入	juǎnrù
高貴	高贵	gāoguì
得多	得多	de5duō
連署	连署	liánshǔ
探望	探望	tànwàng
動亂	动乱	dòngluàn
追隨	追随	zhuīsuí
音效	音效	yīnxiào
治理	治理	zhìlǐ
拖延	拖延	tuōyán
標籤	标签	biāoqiān
噁心	噁心	ěxīn
排放	排放	páifàng
就學	就学	jiùxué
漲價	涨价	zhǎngjià
導入	导入	dǎorù
記憶	记忆	jìyì
智障	智障	zhìzhàng
聞	闻	wén
稱呼	称呼	chēnghū
就學	就学	jiùxué
進駐	进驻	jìnzhù
彙整	汇整	huìzhěng
悲慘	悲惨	bēicǎn
逼近	逼近	bījìn
雇主	雇主	gùzhǔ
新郎	新郎	xīnláng
溫泉	温泉	wēnquán
維也納	维也纳	wéiyěnà
落下	落下	luòxià
農產品	农产品	nóngchǎnpǐn
喜劇	喜剧	xǐjù
聘	聘	pìn
腦部	脑部	nǎobù
痛心	痛心	tòngxīn
逼近	逼近	bījìn
落入	落入	luòrù
碎	碎	suì
散文	散文	sǎnwén
指向	指向	zhǐxiàng
修正案	修正案	xiūzhēngàn
空運	空运	kōngyùn
爬上	爬上	páshàng
哈薩克	哈萨克	hāsàkè
肥胖	肥胖	féipàng
返鄉	返乡	fǎnxiāng
肥胖	肥胖	féipàng
個子	个子	gèzi5
辛勞	辛劳	xīnláo
防衛	防卫	fángwèi
拋棄	抛弃	pāoqì
好評	好评	hǎopíng
快活	快活	kuàihuó
延攬	延揽	yánlǎn
依序	依序	yīxù
辛勞	辛劳	xīnláo
延攬	延揽	yánlǎn
扶	扶	fú
字符	字符	zìfú
佳人	佳人	jiārén
步入	步入	bùrù
利器	利器	lìqì
花樣	花样	huāyàng
好用	好用	hǎoyòng
名片	名片	míngpiàn
拖延	拖延	tuōyán
相片	相片	xiàngpiàn
返鄉	返乡	fǎnxiāng
茁壯	茁壮	zhuózhuàng
指控	指控	zhǐkòng
拍片	拍片	pāipiàn
香煙	香烟	xiāngyān
南投縣	南投县	nántóuxiàn
致命	致命	zhìmìng
空運	空运	kōngyùn
欣慰	欣慰	xīnwèi
穿越	穿越	chuānyuè
小弟	小弟	xiǎodì
月經	月经	yuèjīng
公私立	公私立	gōngsīlì
公害	公害	gōnghài
共襄盛舉	共襄盛举	gòngxiāngshèngjǔ
再三	再三	zàisān
不須	不须	bùxū
出獄	出狱	chūyū
大四	大四	dàsì
公眾	公众	gōngzhòng
人民幣	人民币	rénmínbì
撤銷	撤销	chèxiāo
鼻咽癌	鼻咽癌	bíyānyán
德州	德州	dézhōu
撲	扑	pū
撤銷	撤销	chèxiāo
憑藉	凭藉	píngjiè
頭頂	头顶	tóudǐng
漲價	涨价	zhǎngjià
小心翼翼	小心翼翼	xiǎoxīnyìyì
公噸	公吨	gōngdùn
濫用	滥用	lànyòng
憑藉	凭藉	píngjiè
摘要	摘要	zhāiyào
出賣	出卖	chūmài
壞	坏	huài
論語	论语	lúnyǔ
憑藉	凭藉	píngjiè
寵物	宠物	chǒngwù
購置	购置	gòuzhì
懷抱	怀抱	huáibào
雙打	双打	shuāngdǎ
歸屬	归属	guīshǔ
鎮民	镇民	zhènmín
轉播	转播	zhuǎnbò
轉動	转动	zhuǎndòng
不忍	不忍	bùrěn
繫	系	xì
干擾	干扰	gānrǎo
考績	考绩	kǎojī
不覺	不觉	bùjué
入選	入选	rùxuǎn
出家	出家	chūjiā
會計師	会计师	kuàijìshī
損害	损害	sǔnhài
請來	请来	qǐnglái
趁機	趁机	chènjī
資本額	资本额	zīběné
新穎	新颖	xīnyǐng
歌迷	歌迷	gēmí
碼	码	mǎ
聲勢	声势	shēngshì
總額	总额	zǒngé
聞到	闻到	wéndào
慣例	惯例	guànlì
漠視	漠视	mòshì
踏入	踏入	tàrù
新聞系	新闻系	xīnwénxì
鹿	鹿	lù
蕭	萧	xiāo
謀	谋	móu
談戀愛	谈恋爱	tánliànài
煤	煤	méi
日光	日光	rìguāng
漠視	漠视	mòshì
氣體	气体	qìtǐ
旅途	旅途	lǔtú
索引	索引	suǒyǐn
發炎	发炎	fāyán
創辦	创办	chuàngbàn
無力感	无力感	wúlìgǎn
聖歌	圣歌	shènggē
解剖	解剖	jiěpǒu
隊長	队长	duìzhǎng
新婚	新婚	xīnhūn
輕微	轻微	qīngwéi
復甦	复甦	fùsū
債務	债务	zhàiwù
遍及	遍及	biànjí
超級市場	超级市场	chāojíshìchǎng
賺取	赚取	zhuànqǔ
工讀生	工读生	gōngdúshēng
出租	出租	chūzū
中風	中风	zhòngfēng
生化	生化	shēnghuà
文憑	文凭	wénpíng
出租	出租	chūzū
于	于	yū
下滑	下滑	xiàhuá
趨於	趋于	qūyū
毛巾	毛巾	máojīn
藍天	蓝天	lántiān
聲明	声明	shēngmíng
議論	议论	yìlùn
譴責	谴责	qiǎnzé
蠟燭	蜡烛	làzhú
變更	变更	biàngēng
偵測	侦测	zhēncè
城隍爺	城隍爷	chénghuángyé
小屋	小屋	xiǎowū
占有	占有	zhànyǒu
旗	旗	qí
臺電	台电	táidiàn
積	积	jī
文藝復興	文艺复兴	wényìfùxīng
生下來	生下来	shēngxiàlái
曲折	曲折	qūzhé
加油站	加油站	jiāyóuzhàn
下滑	下滑	xiàhuá
樂隊	乐队	yuèduì
出名	出名	chūmíng
化	化	huà
水溝	水沟	shuǐgōu
中古	中古	zhōnggǔ
主宰	主宰	zhǔzǎi
玉器	玉器	yūqì
主宰	主宰	zhǔzǎi
占有	占有	zhànyǒu
地盤	地盘	dìpán
份	份	fèn
求助	求助	qiúzhù
老實說	老实说	lǎoshíshuō
忠	忠	zhōng
身處	身处	shēnchǔ
交叉	交叉	jiāochā
年畫	年画	niánhuà
自尊	自尊	zìzūn
果園	果园	guǒyuán
有錢人	有钱人	yǒuqiánrén
兩旁	两旁	liǎngpáng
所在地	所在地	suǒzàidì
抹	抹	mǒ
音節	音节	yīnjié
流	流	liú
弱點	弱点	ruòdiǎn
前鋒	前锋	qiánfēng
武裝	武装	wǔzhuāng
石化	石化	shíhuà
改組	改组	gǎizǔ
執	执	zhí
自卑	自卑	zìbēi
佔據	占据	zhànjù
牟	牟	móu
伴奏	伴奏	bànzòu
交響樂團	交响乐团	jiāoxiǎngyuètuán
步行	步行	bùxíng
肝硬化	肝硬化	gānyìnghuà
何謂	何谓	héwèi
作弊	作弊	zuòbì
佔用	占用	zhànyòng
享受到	享受到	xiǎngshòudào
周恩來	周恩来	zhōuēnlái
改組	改组	gǎizǔ
西瓜	西瓜	xīguā
佔用	佔用	zhànyòng
夸克	夸克	kuākè
妓女	妓女	jìnǔ
哥倫比亞	哥伦比亚	gēlúnbǐyǎ
副詞	副词	fùcí
迷惑	迷惑	míhuò
時分	时分	shífēn
迷惑	迷惑	míhuò
迴避	迴避	huíbì
副主席	副主席	fùzhǔxí
狹小	狭小	xiáxiǎo
祭祀	祭祀	jìsì
時間表	时间表	shíjiānbiǎo
帶走	带走	dàizǒu
矩陣	矩阵	jǔzhèn
祭祀	祭祀	jìsì
訪談	访谈	fǎngtán
偵測	侦测	zhēncè
割	割	gē
販售	贩售	fànshòu
執意	执意	zhíyì
托	托	tuō
副所長	副所长	fùsuǒzhǎng
泡茶	泡茶	pàochá
設想	设想	shèxiǎng
青花	青花	qīnghuā
規章	规章	guīzhāng
城牆	城墙	chéngqiáng
武裝	武装	wǔzhuāng
美德	美德	měidé
按摩	按摩	ànmó
自卑	自卑	zìbēi
流露	流露	liúlù
理事會	理事会	lǐshìhuì
爬山	爬山	páshān
拯救	拯救	zhěngjiù
美方	美方	měifāng
紀律	纪律	jìlù
娃娃	娃娃	wáwá
勉勵	勉励	miǎnlì
按摩	按摩	ànmó
流露	流露	liúlù
增資	增资	zēngzī
學識	学识	xuéshì
漏洞	漏洞	lòudòng
營區	营区	yíngqū
預見	预见	yūjiàn
震動	震动	zhèndòng
增資	增资	zēngzī
憂心	忧心	yōuxīn
應對	应对	yìngduì
嘔吐	呕吐	ǒutù
憂心	忧心	yōuxīn
質問	质问	zhíwèn
駕車	驾车	jiàchē
駕	驾	jià
震動	震动	zhèndòng
編碼	编码	biānmǎ
編班	编班	biānbān
綱領	纲领	gānglǐng
換成	换成	huànchéng
勤勞	勤劳	qínláo
木板	木板	mùbǎn
開銷	开销	kāixiāo
演進	演进	yǎnjìn
催	催	cuī
募款	募款	mùkuǎn
善後	善后	shànhòu
復出	复出	fùchū
黑洞	黑洞	hēidòng
演進	演进	yǎnjìn
費時	费时	fèishí
盟軍	盟军	méngjūn
感觸	感触	gǎnchù
就醫	就医	jiùyī
報考	报考	bàokǎo
節節	节节	jiéjié
善後	善后	shànhòu
燕子	燕子	yànzi
經濟學	经济学	jīngjìxué
鏡	镜	jìng
子公司	子公司	zǐgōngsī
下台	下台	xiàtái
打量	打量	dǎliàng
人造	人造	rénzào
方才	方才	fāngcái
布置	布置	bùzhì
手帕	手帕	shǒupà
北投	北投	běitóu
臨	临	lín
公信力	公信力	gōngxìnlì
鷹	鹰	yīng
瀏覽	浏览	liúlǎn
雖說	虽说	suīsuō
蹲	蹲	dūn
變異	变异	biànyì
復出	复出	fùchū
翻譯	翻译	fānyì
加裝	加装	jiāzhuāng
反駁	反驳	fǎnbó
旗幟	旗帜	qízhì
擠滿	挤满	jǐmǎn
共存	共存	gòngcún
文革	文革	wéngé
考古學家	考古学家	kǎogǔxuéjiā
主從	主从	zhǔcóng
回報	回报	huíbào
下台	下台	xiàtái
公用	公用	gōngyòng
編班	编班	biānbān
升遷	升迁	shēngqiān
手錶	手表	shǒubiǎo
外地	外地	wàidì
代	代	dài
天候	天候	tiānhòu
外頭	外头	wàitóu
升遷	升迁	shēngqiān
反駁	反驳	fǎnbó
前科	前科	qiánkē
舌頭	舌头	shétou5
有機	有机	yǒujī
政壇	政坛	zhèngtán
宣示	宣示	xuānshì
急切	急切	jíqiè
軌跡	轨迹	guǐjī
東南	东南	dōngnán
迎面	迎面	yíngmiàn
休憩	休憩	xiūqì
咦	咦	yí
套牢	套牢	tàoláo
爹	爹	diē
宮廷	宫廷	gōngtíng
砂石車	砂石车	shāshíchē
限定	限定	xiàndìng
庭院	庭院	tíngyuàn
建立起	建立起	jiànlìqǐ
投下	投下	tóuxià
亂象	乱象	luànxiàng
簽	签	qiān
尖銳	尖锐	jiānruì
列舉	列举	lièjǔ
作曲	作曲	zuòqǔ
波灣	波湾	bōwān
底層	底层	dǐcéng
延遲	延迟	yánchí
收看	收看	shōukàn
奔馳	奔驰	bēnchí
延遲	延迟	yánchí
作曲	作曲	zuòqǔ
自古以來	自古以来	zìgǔyǐlái
匈牙利	匈牙利	xiōngyálì
自行車	自行车	zìxíngchē
走廊	走廊	zǒuláng
老太婆	老太婆	lǎotàipó
休憩	休憩	xiūqì
在職	在职	zàizhí
高壓	高压	gāoyā
基隆市	基隆市	jīlóngshì
砸	砸	zá
排行榜	排行榜	páihángbǎng
問到	问到	wèndào
統籌	统筹	tǒngchóu
閃爍	闪烁	shǎnshuò
晚	晚	wǎn
野狼	野狼	yěláng
啟動	启动	qǐdòng
消費性	消费性	xiāofèixìng
迴響	迴响	huíxiǎng
統獨	统独	tǒngdú
崗位	岗位	gāngwèi
假裝	假装	jiǎzhuāng
逃逸	逃逸	táoyì
急於	急于	jíyū
亟待	亟待	jídài
啟動	启动	qǐdòng
強行	强行	qiángxíng
知性	知性	zhīxìng
突	突	tú
排球	排球	páiqiú
省下	省下	shěngxià
套牢	套牢	tàoláo
動脈	动脉	dòngmài
控告	控告	kònggào
草叢	草丛	cǎocóng
曹	曹	cáo
連	连	lián
副總裁	副总裁	fùzǒngcái
退伍	退伍	tuìwǔ
淵源	渊源	yuānyuán
茫然	茫然	mángrán
從容	从容	cōngróng
統籌	统筹	tǒngchóu
張力	张力	zhānglì
崇高	崇高	chónggāo
婚前	婚前	hūnqián
過夜	过夜	guòyè
割禮	割礼	gēlǐ
開採	开采	kāicǎi
當面	当面	dāngmiàn
視力	视力	shìlì
罪名	罪名	zuìmíng
滑	滑	huá
模具	模具	mójù
開採	开采	kāicǎi
話語	话语	huàyǔ
聖火	圣火	shènghuǒ
寫字	写字	xiězì
電影院	电影院	diànyǐngyuàn
賜	赐	sì
閏	闰	rùn
磚	砖	zhuān
億	亿	yì
踏出	踏出	tàchū
銀	银	yín
解開	解开	jiěkāi
臉頰	脸颊	liǎnjiá
箱	箱	xiāng
猜測	猜测	cāicè
傳說	传说	chuánshuō
塞車	塞车	sāichē
善於	善于	shànyū
新型	新型	xīnxíng
爽	爽	shuǎng
督導	督导	dūdǎo
鈣	钙	gài
運動場	运动场	yùndòngcháng
發布	发布	fābù
解散	解散	jiěsàn
游	游	yóu
想念	想念	xiǎngniàn
盞	盏	zhǎn
督導	督导	dūdǎo
無效	无效	wúxiào
平和	平和	pínghé
平民	平民	píngmín
外資	外资	wàizī
用水	用水	yòngshuǐ
不適	不适	búshì
日人	日人	rìrén
不僅僅	不仅仅	bùjǐnjǐn
聽覺	听觉	tīngjué
工商界	工商界	gōngshāngjiè
引述	引述	yǐnshù
出局	出局	chūjú
騷動	骚动	sāodòng
謎	谜	mí
櫥窗	橱窗	chúchuāng
教職	教职	jiàozhí
闖	闯	chuǎng
訝異	讶异	yàyì
警探	警探	jǐngtàn
天安門	天安门	tiānānmén
不許	不许	bùxǔ
榮耀	荣耀	róngyào
稽查	稽查	jīchá
誤會	误会	wùhuì
遠方	远方	yuǎnfāng
漢子	汉子	hànzi5
廟宇	庙宇	miàoyǔ
稽查	稽查	jīchá
撒	撒	sā
不休	不休	bùxiū
化成	化成	huàchéng
化	化	huà
正常化	正常化	zhēngchánghuà
奶	奶	nǎi
山路	山路	shānlù
正規	正规	zhèngguī
正常化	正常化	zhēngchánghuà
生態系	生态系	shēngtàixì
主演	主演	zhǔyǎn
緊接著	紧接着	jǐnjiēzhe5
上天	上天	shàngtiān
房舍	房舍	fángshè
奔波	奔波	bēnbō
西藏	西藏	xīzàng
名家	名家	míngjiā
告別	告别	gàobié
自費	自费	zìfèi
同等	同等	tóngděng
病友	病友	bìngyǒu
直銷	直销	zhíxiāo
附屬	附属	fùshǔ
奔波	奔波	bēnbō
查出	查出	cháchū
流於	流于	liúyú
空調	空调	kōngtiáo
花費	花费	huāfèi
省主席	省主席	shěngzhǔxí
苦惱	苦恼	kǔnǎo
拉回	拉回	lāhuí
石器	石器	shíqì
延後	延后	yánhòu
陶冶	陶冶	táoyě
奔	奔	bēn
缺席	缺席	quēxí
自豪	自豪	zìháo
安養	安养	ānyǎng
百分比	百分比	bǎifēnbǐ
助力	助力	zhùlì
如是	如是	rúshì
年初	年初	niánchū
名將	名将	míngjiàng
西式	西式	xīshì
良多	良多	liángduō
交通局	交通局	jiāotōngjú
使命感	使命感	shǐmìnggǎn
注入	注入	zhùrù
合力	合力	hélì
自覺	自觉	zìjué
白宮	白宫	báigōng
陶冶	陶冶	táoyě
疏離	疏离	shūlí
逛街	逛街	jiē
核	核	hé
草坪	草坪	cǎopíng
航行	航行	hángxíng
深切	深切	shēnqiè
紮實	紮实	zāshí
偏	偏	piān
康熙	康熙	kāngxī
探險	探险	tànxiǎn
訝異	讶异	yàyì
婦運	妇运	fùyùn
猜測	猜测	cāicè
動輒	动辄	dòngzhé
缺席	缺席	quēxí
看出來	看出来	kànchūlái
安養	安养	ānyǎng
深山	深山	shēnshān
背部	背部	bèibù
胸部	胸部	xiōngbù
急忙	急忙	jímáng
明月	明月	míngyuè
胡琴	胡琴	húqín
頂	顶	dǐng
射箭	射箭	shèjiàn
洶湧	汹湧	xiōngyǒng
射擊	射击	shèjí
常務	常务	chángwù
高聳	高耸	gāosǒng
叛亂	叛乱	pànluàn
盒子	盒子	hézi5
抵制	抵制	dǐzhì
神父	神父	shénfù
疏離	疏离	shūlí
航權	航权	hángquán
叛亂	叛乱	pànluàn
抵制	抵制	dǐzhì
愛惜	爱惜	àixí
預期	预期	yūqí
預售	预售	yūshòu
墮落	堕落	duòluò
察覺	察觉	chájué
墮落	堕落	duòluò
睜	睁	zhēng
輪廓	轮廓	lúnkuò
戰術	战术	zhànshù
輪到	轮到	lúndào
管理局	管理局	guǎnlǐjú
機緣	机缘	jīyuán
稱得上	称得上	chēngde5shàng
磨	磨	mó
畫出	画出	huàchū
臺南市	台南市	táinánshì
說明書	说明书	shuōmíngshū
極限	极限	jíxiàn
水晶	水晶	shuǐjīng
圖書室	图书室	túshūshì
旋轉	旋转	xuánzhuǎn
插入	插入	chārù
勘查	勘查	kānchá
無異	无异	wúyì
惹	惹	rě
跟蹤	跟踪	gēnzōng
搶購	抢购	qiǎnggòu
紫外線	紫外线	zǐwàixiàn
飲用	饮用	yǐnyòng
無助	无助	wúzhù
朝野	朝野	cháoyě
誠如	诚如	chéngrú
過分	过分	guòfèn
喉嚨	喉咙	hóulóng
跟蹤	跟踪	gēnzōng
水流	水流	shuǐliú
仙	仙	xiān
必備	必备	bìbèi
切斷	切断	qiēduàn
回溯	回溯	huísù
本錢	本钱	běnqián
一天到晚	一天到晚	yītiāndàowǎn
手勢	手势	shǒushì
少量	少量	shǎoliàng
大臣	大臣	dàchén
蘭花	兰花	lánhuā
繪製	绘制	huìzhì
斷層	断层	duàncéng
擺設	摆设	bǎishè
點子	点子	diǎnzi5
勘查	勘查	kānchá
擔負	担负	dānfù
再一次	再一次	zàiyīcì
全心	全心	quánxīn
標示	标示	biāoshì
一齊	一齐	yīqí
大抵	大抵	dàdǐ
下方	下方	xiàfāng
在在	在在	zàizài
考卷	考卷	kǎojuàn
文明	文明	wénmíng
不約而同	不约而同	bùyuēértóng
辦事	办事	bànshì
分別	分别	fēnbié
山坡地	山坡地	shānpōdì
火力	火力	huǒlì
市銀	市银	shìyín
不住	不住	búzhù
打仗	打仗	dǎzhàng
可惡	可恶	kěwù
心愛	心爱	xīnài
美容	美容	měiróng
面目	面目	miànmù
到時	到时	dàoshí
宮殿	宫殿	gōngdiàn
查報	查报	chábào
兼差	兼差	jiānchāi
美洲	美洲	měizhōu
有鑑於此	有鑑于此	yǒujiànyūcǐ
拜會	拜会	bàihuì
有形	有形	yǒuxíng
明定	明定	míngdìng
突發	突发	túfā
查報	查报	chábào
若非	若非	ruòfēi
美容	美容	měiróng
某某	某某	mǒumǒu
版畫	版画	bǎnhuà
查緝	查缉	cháqì
老闆娘	老板娘	lǎobǎnniáng
預	预	yū
名人	名人	míngrén
放開	放开	fàngkāi
名列	名列	míngliè
安理會	安理会	ānlǐhuì
成見	成见	chéngjiàn
底片	底片	dǐpiàn
合資	合资	hézī
回升	回升	huíshēng
形容詞	形容词	xíngróngcí
州立	州立	zhōulì
序列	序列	xùliè
走近	走近	zǒujìn
免不了	免不了	miǎnbùliǎo
扛	扛	kāng
尖	尖	jiān
身分證	身分证	shēnfènzhèng
租用	租用	zūyòng
殷切	殷切	yīnqiè
純真	纯真	chúnzhēn
統一	统一	tǒngyī
偶然	偶然	ǒurán
時	时	shí
狹義	狭义	xiáyì
扇	扇	shàn
甜蜜	甜蜜	tiánmì
採訪	采访	cǎifǎng
租用	租用	zūyòng
祖父	祖父	zǔfù
掌控	掌控	zhǎngkòng
迷你	迷你	mínǐ
查緝	查缉	cháqì
冷戰	冷战	lěngzhàn
甜蜜	甜蜜	tiánmì
泉州	泉州	quánzhōu
洋溢	洋溢	yángyì
寄給	寄给	jìgěi
杭州	杭州	hángzhōu
第一線	第一线	dìyīxiàn
真心	真心	zhēnxīn
為難	为难	wéinán
風采	风采	fēngcǎi
套	套	tào
甚多	甚多	shènduō
排行	排行	páiháng
前瞻性	前瞻性	qiánzhānxìng
旋轉	旋转	xuánzhuǎn
珊瑚	珊瑚	shānhú
政見	政见	zhèngjiàn
拜會	拜会	bàihuì
放過	放过	fàngguò
炫耀	炫耀	xuànyào
團長	团长	tuánzhǎng
遙測	遥测	yáocè
確切	确切	quèqiè
調查員	调查员	diàocháyuán
調降	调降	tiáojiàng
論述	论述	lùnshù
遣返	遣返	qiǎnfǎn
彈琴	弹琴	tánqín
毆打	殴打	ōudǎ
踏實	踏实	tàshí
鋼筋	钢筋	gāngjīn
電路	电路	diànlù
敷衍	敷衍	fūyǎn
福爾摩沙	福尔摩沙	fúěrmóshā
遣返	遣返	qiǎnfǎn
擁	拥	yǒng
說詞	说词	shuōcí
提報	提报	tíbào
電器	电器	diànqì
解答	解答	jiědá
藝廊	艺廊	yìláng
暴漲	暴涨	bàozhǎng
愛樂	爱乐	àiyuè
溪水	溪水	xīshuǐ
躲避	躲避	duǒbì
傻	傻	shǎ
搶救	抢救	qiǎngjiù
落伍	落伍	luòwǔ
過日子	过日子	guòrìzi5
黃河	黄河	huánghé
聲望	声望	shēngwàng
尊	尊	zūn
催眠	催眠	cuīmián
筆觸	笔触	bǐchù
落伍	落伍	luòwǔ
搶救	抢救	qiǎngjiù
廚師	厨师	chúshī
毆打	殴打	ōudǎ
慶幸	庆幸	qìngxìng
款項	款项	kuǎnxiàng
引誘	引诱	yǐnyòu
刀	刀	dāo
山羊	山羊	shānyáng
子宮	子宫	zǐgōng
用人	用人	yòngrén
上岸	上岸	shàngàn
公克	公克	gōngkè
引誘	引诱	yǐnyòu
才藝	才艺	cáiyì
不便	不便	búbiàn
水墨畫	水墨画	shuǐmòhuà
反對黨	反对党	fǎnduìdǎng
生產線	生产线	shēngchǎnxiàn
地質	地质	dìzhí
渡	渡	dù
繼而	继而	jìér
觸角	触角	chùjiǎo
關島	关岛	guāndǎo
讀到	读到	dúdào
禮品	礼品	lǐpǐn
中文系	中文系	zhōngwénxì
犯錯	犯错	fàncuò
劉邦	刘邦	liúbāng
獲悉	获悉	huòxī
獲准	获准	huòzhǔn
獲益	获益	huòyì
遙測	遥测	yáocè
外套	外套	wàitào
二胡	二胡	èrhú
用處	用处	yòngchù
十二指腸	十二指肠	shíèrzhǐcháng
上當	上当	shàngdàng
暴漲	暴涨	bàozhǎng
牛郎	牛郎	nióuláng
刊出	刊出	kānchū
共通	共通	gòngtōng
用具	用具	yòngjù
失調	失调	shītiáo
左右	左右	zuǒyòu
比喻	比喻	bǐyū
犯錯	犯错	fàncuò
倒楣	倒楣	dǎoméi
爭吵	争吵	zhēngchǎo
孤兒	孤儿	gūér
併發症	并发症	bìngfāzhèng
印製	印制	yìnzhì
吃到	吃到	chīdào
求職	求职	qiúzhí
海鮮	海鲜	hǎixiān
降落	降落	jiàngluò
求職	求职	qiúzhí
波及	波及	bōjí
收	收	shōu
科學院	科学院	kēxuéyuàn
信箱	信箱	xìnxiāng
降落	降落	jiàngluò
室友	室友	shìyǒu
招募	招募	zhāomù
保密	保密	bǎomì
版面	版面	bǎnmiàn
秉持	秉持	bǐngchí
皇室	皇室	huángshì
受騙	受骗	shòupiàn
屬下	属下	shǔxià
刑事	刑事	xíngshì
居家	居家	jūjiā
陽	阳	yáng
良知	良知	liángzhī
成名	成名	chéngmíng
划船	划船	huáchuán
成名	成名	chéngmíng
困惑	困惑	kùnhuò
灰	灰	huī
有情	有情	yǒuqíng
肝病	肝病	gānbìng
吃飽	吃饱	chībǎo
伴侶	伴侣	bànlǔ
地處	地处	dìchǔ
困惑	困惑	kùnhuò
光電	光电	guāngdiàn
划船	划船	huáchuán
企圖	企图	qìtú
杜鵑	杜鹃	dùjuān
高昂	高昂	gāoáng
鬼神	鬼神	guǐshén
討	讨	tǎo
愉悅	愉悦	yūyuè
清楚	清楚	qīngchǔ
國寶	国宝	guóbǎo
消逝	消逝	xiāoshì
逃走	逃走	táozǒu
高空	高空	gāokōng
這樣一來	这样一来	zhèyàngyīlái
趁著	趁着	chènzhe5
密	密	mì
梅花	梅花	méihuā
軟片	软片	ruǎnpiàn
乾乾淨淨	乾乾淨淨	gāngānjìngjìng
運送	运送	yùnsòng
眉毛	眉毛	méimáo
帛琉	帛琉	bóliú
專櫃	专柜	zhuānguì
迫不及待	迫不及待	pòbùjídài
俱	俱	jù
跑道	跑道	pǎodào
專程	专程	zhuānchéng
招募	招募	zhāomù
唇	唇	chún
花兒	花儿	huāér
爭吵	争吵	zhēngchǎo
波及	波及	bōjí
美味	美味	měiwèi
為限	为限	wéixiàn
責任感	责任感	zérèngǎn
愉悅	愉悦	yūyuè
紡織	纺织	fǎngzhī
淡水河	淡水河	dànshuǐhé
衰	衰	shuāi
脫穎而出	脱颖而出	tuōyǐngérchū
晒	晒	shài
掃描器	扫描器	sǎomiáoqì
捷克	捷克	jiékè
紡織	纺织	fǎngzhī
掩飾	掩饰	yǎnshì
滿滿	满满	mǎnmǎn
機組	机组	jīzǔ
遲到	迟到	chídào
締造	缔造	dìzào
謀求	谋求	móuqiú
操縱	操纵	cāozòng
幕	幕	mù
嘴唇	嘴唇	zuǐchún
賭	赌	dǔ
壓低	压低	yādī
盤子	盘子	pánzi5
實況	实况	shíkuàng
歌星	歌星	gēxīng
數值	数值	shùzhí
意圖	意图	yìtú
導盲犬	导盲犬	dǎomángquǎn
褲子	裤子	kùzi5
學運	学运	xuéyùn
感傷	感伤	gǎnshāng
裝修	装修	zhuāngxiū
反共	反共	fǎngòng
水域	水域	shuǐyū
復健	复健	fùjiàn
傳入	传入	chuánrù
董監事	董监事	dǒngjiānshì
新莊	新庄	xīnzhuāng
感傷	感伤	gǎnshāng
意味	意味	yìwèi
獎品	奖品	jiǎngpǐn
精品	精品	jīngpǐn
廢物	废物	fèiwù
截	截	jié
德國人	德国人	déguórén
預賽	预赛	yūsài
締造	缔造	dìzào
療效	疗效	liáoxiào
嫌疑	嫌疑	xiányí
聲浪	声浪	shēnglàng
巨星	巨星	jùxīng
生計	生计	shēngjì
申辦	申办	shēnbàn
體壇	体坛	tǐtán
寶島	宝岛	bǎodǎo
禮服	礼服	lǐfú
歸來	归来	guīlái
必要性	必要性	bìyàoxìng
擴建	扩建	kuòjiàn
不幸	不幸	búxìng
續集	续集	xùjí
獵物	猎物	lièwù
轉機	转机	zhuǎnjī
籤	籤	qiān
攝影師	摄影师	shèyǐngshī
羅浮宮	罗浮宫	luófúgōng
開戰	开战	kāizhàn
罐頭	罐头	guàntóu
生平	生平	shēngpíng
